адепт|ад+эпт
адепта|ад+эпта
адепту|ад+эпту
адептом|ад+эптом
адепте|ад+эпте
адепты|ад+эпты
адептов|ад+эптов
адептам|ад+эптам
адептами|ад+эптами
адептах|ад+эптах
детектив|дэтэкт+ив
детектива|дэтэкт+ива
детективу|дэтэкт+иву
детективом|дэтэкт+ивом
детективе|дэтэкт+иве
детективы|дэтэкт+ивы
детективов|дэтэкт+ивов
детективам|дэтэкт+ивам
детективами|дэтэкт+ивами
детективах|дэтэкт+ивах
адекватный|адэкв+атный
адекватного|адэкв+атного
адекватному|адэкв+атному
адекватным|адэкв+атным
адекватном|адэкв+атном
адекватная|адэкв+атная
адекватной|адэкв+атной
адекватную|адэкв+атную
адекватною|адэкв+атною
адекватное|адэкв+атное
адекватные|адэкв+атные
адекватных|адэкв+атных
адекватными|адэкв+атными
адекватен|адэкв+атен
адекватна|адэкв+атна
адекватно|адэкв+атно
адекватны|адэкв+атны
адекватнее|адэкв+атнее
адекватней|адэкв+атней
поадекватнее|поадэкв+атнее
поадекватней|поадэкв+атней
аннексия|анн+эксия
аннексии|анн+эксии
аннексию|анн+эксию
аннексией|анн+эксией
аннексиею|анн+эксиею
аннексий|анн+эксий
аннексиям|анн+эксиям
аннексиями|анн+эксиями
аннексиях|анн+эксиях
антисептик|антис+эптик
антисептика|антис+эптика
антисептику|антис+эптику
антисептиком|антис+эптиком
антисептике|антис+эптике
антисептики|антис+эптики
антисептиков|антис+эптиков
антисептикам|антис+эптикам
антисептиками|антис+эптиками
антисептиках|антис+эптиках
атеизм|атэ+изм
атеизма|атэ+изма
атеизму|атэ+изму
атеизмом|атэ+измом
атеизме|атэ+изме
атеизмы|атэ+измы
атеизмов|атэ+измов
атеизмам|атэ+измам
атеизмами|атэ+измами
атеизмах|атэ+измах
атеист|атэ+ист
атеиста|атэ+иста
атеисту|атэ+исту
атеистом|атэ+истом
атеисте|атэ+исте
атеисты|атэ+исты
атеистов|атэ+истов
атеистам|атэ+истам
атеистами|атэ+истами
атеистах|атэ+истах
бизнес|б+изнэс
бизнеса|б+изнэса
бизнесу|б+изнэсу
бизнесом|б+изнэсом
бизнесе|б+изнэсе
бизнесы|б+изнэсы
бизнесов|б+изнэсов
бизнесам|б+изнэсам
бизнесами|б+изнэсами
бизнесах|б+изнэсах
гетера|гет+эра
гетеры|гет+эры
гетере|гет+эре
гетеру|гет+эру
гетерой|гет+эрой
гетерою|гет+эрою
гетер|гет+эр
гетерам|гет+эрам
гетерами|гет+эрами
гетерах|гет+эрах
гротеск|грот+эск
гротеска|грот+эска
гротеску|грот+эску
гротеском|грот+эском
гротеске|грот+эске
гротески|грот+эски
гротесков|грот+эсков
гротескового|грот+эскового
гротесковому|грот+эсковому
гротесковым|грот+эсковым
гротесковом|грот+эсковом
гротесковая|грот+эсковая
гротесковой|грот+эсковой
гротесковую|грот+эсковую
гротесковою|грот+эсковою
гротесковое|грот+эсковое
гротесковые|грот+эсковые
гротесковых|грот+эсковых
гротесковыми|грот+эсковыми
гротескова|грот+эскова
гротесково|грот+эсково
гротесковы|грот+эсковы
гротесковее|грот+эсковее
гротесковей|грот+эсковей
гротескам|грот+эскам
гротесками|грот+эсками
гротесках|грот+эсках
дебаркадер|дэбарк+адэр
дебаркадера|дэбарк+адэра
дебаркадеру|дэбарк+адэру
дебаркадером|дэбарк+адэром
дебаркадере|дэбарк+адэре
дебаркадеры|дэбарк+адэры
дебаркадеров|дэбарк+адэров
дебаркадерам|дэбарк+адэрам
дебаркадерами|дэбарк+адэрами
дебаркадерах|дэбарк+адэрах
девальвация|дэвальв+ация
девальвации|дэвальв+ации
девальвацию|дэвальв+ацию
девальвацией|дэвальв+ацией
девальвациею|дэвальв+ациею
девальваций|дэвальв+аций
девальвациям|дэвальв+ациям
девальвациями|дэвальв+ациями
девальвациях|дэвальв+ациях
деградация|дэград+ация
деградации|дэград+ации
деградацию|дэград+ацию
деградацией|дэград+ацией
деградациею|дэград+ациею
деградаций|дэград+аций
деградациям|дэград+ациям
деградациями|дэград+ациями
деградациях|дэград+ациях
дегрессия|дэгр+ессия
дегрессии|дэгр+ессии
дегрессию|дэгр+ессию
дегрессией|дэгр+ессией
дегрессиею|дэгр+ессиею
дегрессий|дэгр+ессий
дегрессиям|дэгр+ессиям
дегрессиями|дэгр+ессиями
дегрессиях|дэгр+ессиях
дегуманизация|дэгуманиз+ация
дегуманизации|дэгуманиз+ации
дегуманизацию|дэгуманиз+ацию
дегуманизацией|дэгуманиз+ацией
дегуманизациею|дэгуманиз+ациею
дегуманизаций|дэгуманиз+аций
дегуманизациям|дэгуманиз+ациям
дегуманизациями|дэгуманиз+ациями
дегуманизациях|дэгуманиз+ациях
дезавуировать|дэзаву+ировать
дезавуировал|дэзаву+ировал
дезавуировала|дэзаву+ировала
дезавуировало|дэзаву+ировало
дезавуировали|дэзаву+ировали
дезавуирую|дэзаву+ирую
дезавуируем|дэзаву+ируем
дезавуируешь|дэзаву+ируешь
дезавуируете|дэзаву+ируете
дезавуирует|дэзаву+ирует
дезавуируют|дэзаву+ируют
дезавуируемте|дэзаву+ируемте
дезавуируй|дэзаву+ируй
дезавуируйте|дэзаву+ируйте
дезавуировавший|дэзаву+ировавший
дезавуировавшего|дэзаву+ировавшего
дезавуировавшему|дэзаву+ировавшему
дезавуировавшим|дэзаву+ировавшим
дезавуировавшем|дэзаву+ировавшем
дезавуировавшая|дэзаву+ировавшая
дезавуировавшей|дэзаву+ировавшей
дезавуировавшую|дэзаву+ировавшую
дезавуировавшею|дэзаву+ировавшею
дезавуировавшее|дэзаву+ировавшее
дезавуировавшие|дэзаву+ировавшие
дезавуировавших|дэзаву+ировавших
дезавуировавшими|дэзаву+ировавшими
дезавуированный|дэзаву+ированный
дезавуированного|дэзаву+ированного
дезавуированному|дэзаву+ированному
дезавуированным|дэзаву+ированным
дезавуированном|дэзаву+ированном
дезавуированная|дэзаву+ированная
дезавуированной|дэзаву+ированной
дезавуированную|дэзаву+ированную
дезавуированною|дэзаву+ированною
дезавуированное|дэзаву+ированное
дезавуированные|дэзаву+ированные
дезавуированных|дэзаву+ированных
дезавуированными|дэзаву+ированными
дезавуировав|дэзаву+ировав
дезавуировавши|дэзаву+ировавши
дезавуирующий|дэзаву+ирующий
дезавуирующего|дэзаву+ирующего
дезавуирующему|дэзаву+ирующему
дезавуирующим|дэзаву+ирующим
дезавуирующем|дэзаву+ирующем
дезавуирующая|дэзаву+ирующая
дезавуирующей|дэзаву+ирующей
дезавуирующую|дэзаву+ирующую
дезавуирующею|дэзаву+ирующею
дезавуирующее|дэзаву+ирующее
дезавуирующие|дэзаву+ирующие
дезавуирующих|дэзаву+ирующих
дезавуирующими|дэзаву+ирующими
дезавуируемый|дэзаву+ируемый
дезавуируемого|дэзаву+ируемого
дезавуируемому|дэзаву+ируемому
дезавуируемым|дэзаву+ируемым
дезавуируемом|дэзаву+ируемом
дезавуируемая|дэзаву+ируемая
дезавуируемой|дэзаву+ируемой
дезавуируемую|дэзаву+ируемую
дезавуируемою|дэзаву+ируемою
дезавуируемое|дэзаву+ируемое
дезавуируемые|дэзаву+ируемые
дезавуируемых|дэзаву+ируемых
дезавуируемыми|дэзаву+ируемыми
дезавуируя|дэзаву+ируя
дезавуируема|дэзаву+ируема
дезавуируемо|дэзаву+ируемо
дезавуируемы|дэзаву+ируемы
дезавуирован|дэзаву+ирован
дезавуирована|дэзаву+ирована
дезавуировано|дэзаву+ировано
дезавуированы|дэзаву+ированы
дезорганизация|дэзорганиз+ация
дезорганизации|дэзорганиз+ации
дезорганизацию|дэзорганиз+ацию
дезорганизацией|дэзорганиз+ацией
дезорганизациею|дэзорганиз+ациею
дезорганизаций|дэзорганиз+аций
дезорганизациям|дэзорганиз+ациям
дезорганизациями|дэзорганиз+ациями
дезорганизациях|дэзорганиз+ациях
декаэдр|дэк+аэдр
декаэдра|дэк+аэдра
декаэдру|дэк+аэдру
декаэдром|дэк+аэдром
декаэдре|дэк+аэдре
декаэдры|дэк+аэдры
декаэдров|дэк+аэдров
декаэдрам|дэк+аэдрам
декаэдрами|дэк+аэдрами
декаэдрах|дэк+аэдрах
деквалификация|дэквалифик+ация
деквалификации|дэквалифик+ации
деквалификацию|дэквалифик+ацию
деквалификацией|дэквалифик+ацией
деквалификациею|дэквалифик+ациею
деквалификаций|дэквалифик+аций
деквалификациям|дэквалифик+ациям
деквалификациями|дэквалифик+ациями
деквалификациях|дэквалифик+ациях
декольте|дэкольт+э
декольтировать|дэкольт+ировать
декольтировал|дэкольт+ировал
декольтировала|дэкольт+ировала
декольтировало|дэкольт+ировало
декольтировали|дэкольт+ировали
декольтирую|дэкольт+ирую
декольтируем|дэкольт+ируем
декольтируешь|дэкольт+ируешь
декольтируете|дэкольт+ируете
декольтирует|дэкольт+ирует
декольтируют|дэкольт+ируют
декольтируемте|дэкольт+ируемте
декольтируй|дэкольт+ируй
декольтируйте|дэкольт+ируйте
декольтировавший|дэкольт+ировавший
декольтировавшего|дэкольт+ировавшего
декольтировавшему|дэкольт+ировавшему
декольтировавшим|дэкольт+ировавшим
декольтировавшем|дэкольт+ировавшем
декольтировавшая|дэкольт+ировавшая
декольтировавшей|дэкольт+ировавшей
декольтировавшую|дэкольт+ировавшую
декольтировавшею|дэкольт+ировавшею
декольтировавшее|дэкольт+ировавшее
декольтировавшие|дэкольт+ировавшие
декольтировавших|дэкольт+ировавших
декольтировавшими|дэкольт+ировавшими
декольтированный|дэкольт+ированный
декольтированного|дэкольт+ированного
декольтированному|дэкольт+ированному
декольтированным|дэкольт+ированным
декольтированном|дэкольт+ированном
декольтированная|дэкольт+ированная
декольтированной|дэкольт+ированной
декольтированную|дэкольт+ированную
декольтированною|дэкольт+ированною
декольтированное|дэкольт+ированное
декольтированные|дэкольт+ированные
декольтированных|дэкольт+ированных
декольтированными|дэкольт+ированными
декольтировав|дэкольт+ировав
декольтировавши|дэкольт+ировавши
декольтирующий|дэкольт+ирующий
декольтирующего|дэкольт+ирующего
декольтирующему|дэкольт+ирующему
декольтирующим|дэкольт+ирующим
декольтирующем|дэкольт+ирующем
декольтирующая|дэкольт+ирующая
декольтирующей|дэкольт+ирующей
декольтирующую|дэкольт+ирующую
декольтирующею|дэкольт+ирующею
декольтирующее|дэкольт+ирующее
декольтирующие|дэкольт+ирующие
декольтирующих|дэкольт+ирующих
декольтирующими|дэкольт+ирующими
декольтируемый|дэкольт+ируемый
декольтируемого|дэкольт+ируемого
декольтируемому|дэкольт+ируемому
декольтируемым|дэкольт+ируемым
декольтируемом|дэкольт+ируемом
декольтируемая|дэкольт+ируемая
декольтируемой|дэкольт+ируемой
декольтируемую|дэкольт+ируемую
декольтируемою|дэкольт+ируемою
декольтируемое|дэкольт+ируемое
декольтируемые|дэкольт+ируемые
декольтируемых|дэкольт+ируемых
декольтируемыми|дэкольт+ируемыми
декольтируя|дэкольт+ируя
декольтируема|дэкольт+ируема
декольтируемо|дэкольт+ируемо
декольтируемы|дэкольт+ируемы
декольтирован|дэкольт+ирован
декольтирована|дэкольт+ирована
декольтировано|дэкольт+ировано
декольтированы|дэкольт+ированы
декольтированна|дэкольт+ированна
декольтированно|дэкольт+ированно
декольтированны|дэкольт+ированны
декольтированнее|дэкольт+ированнее
декольтированней|дэкольт+ированней
подекольтированнее|подэкольт+ированнее
подекольтированней|подэкольт+ированней
декомпенсация|дэкомпенс+ация
декомпенсации|дэкомпенс+ации
декомпенсацию|дэкомпенс+ацию
декомпенсацией|дэкомпенс+ацией
декомпенсациею|дэкомпенс+ациею
декомпенсаций|дэкомпенс+аций
декомпенсациям|дэкомпенс+ациям
декомпенсациями|дэкомпенс+ациями
декомпенсациях|дэкомпенс+ациях
декор|дэк+ор
декора|дэк+ора
декору|дэк+ору
декором|дэк+ором
декоре|дэк+оре
декоры|дэк+оры
декоров|дэк+оров
декорам|дэк+орам
декорами|дэк+орами
декорах|дэк+орах
деликатес|дэликат+ес
деликатеса|дэликат+еса
деликатесу|дэликат+есу
деликатесом|дэликат+есом
деликатесе|дэликат+есе
деликатесы|дэликат+есы
деликатесов|дэликат+есов
деликатесам|дэликат+есам
деликатесами|дэликат+есами
деликатесах|дэликат+есах
демарш|дэм+арш
демарша|дэм+арша
демаршу|дэм+аршу
демаршем|дэм+аршем
демарше|дэм+арше
демарши|дэм+арши
демаршей|дэм+аршей
демаршам|дэм+аршам
демаршами|дэм+аршами
демаршах|дэм+аршах
демос|д+эмос
демоса|д+эмоса
демосу|д+эмосу
демосом|д+эмосом
демосе|д+эмосе
демосы|д+эмосы
демосов|д+эмосов
демосам|д+эмосам
демосами|д+эмосами
демосах|д+эмосах
демпинг|д+эмпинг
демпинга|д+эмпинга
демпингу|д+эмпингу
демпингом|д+эмпингом
демпинге|д+эмпинге
демпинги|д+эмпинги
демпингов|д+эмпингов
демпингового|д+эмпингового
демпинговому|д+эмпинговому
демпинговым|д+эмпинговым
демпинговом|д+эмпинговом
демпинговая|д+эмпинговая
демпинговой|д+эмпинговой
демпинговую|д+эмпинговую
демпинговою|д+эмпинговою
демпинговое|д+эмпинговое
демпинговые|д+эмпинговые
демпинговых|д+эмпинговых
демпинговыми|д+эмпинговыми
демпингова|д+эмпингова
демпингово|д+эмпингово
демпинговы|д+эмпинговы
демпинговее|д+эмпинговее
демпинговей|д+эмпинговей
демпингам|д+эмпингам
демпингами|д+эмпингами
демпингах|д+эмпингах
дендролог|дэндр+олог
дендролога|дэндр+олога
дендрологий|дэндр+ологий
дендрологого|дэндр+ологого
дендрологому|дэндр+ологому
дендрологим|дэндр+ологим
дендрологая|дэндр+ологая
дендрологой|дэндр+ологой
дендрологую|дэндр+ологую
дендрологою|дэндр+ологою
дендрологое|дэндр+ологое
дендрологие|дэндр+ологие
дендрологих|дэндр+ологих
дендрологими|дэндр+ологими
дендролого|дэндр+олого
дендроложе|дэндр+оложе
дендрологу|дэндр+ологу
дендрологом|дэндр+ологом
дендрологе|дэндр+ологе
дендрологов|дэндр+ологов
дендрологово|дэндр+ологово
дендрологова|дэндр+ологова
дендрологову|дэндр+ологову
дендрологовом|дэндр+ологовом
дендрологове|дэндр+ологове
дендрологовам|дэндр+ологовам
дендрологовами|дэндр+ологовами
дендрологовах|дэндр+ологовах
дендрологам|дэндр+ологам
дендрологама|дэндр+ологама
дендрологаму|дэндр+ологаму
дендрологамом|дэндр+ологамом
дендрологаме|дэндр+ологаме
дендрологамы|дэндр+ологамы
дендрологамов|дэндр+ологамов
дендрологамам|дэндр+ологамам
дендрологамами|дэндр+ологамами
дендрологамах|дэндр+ологамах
дендрологами|дэндр+ологами
дендрологах|дэндр+ологах
дендрологи|дэндр+ологи
деноминация|дэномин+ация
деноминации|дэномин+ации
деноминацию|дэномин+ацию
деноминацией|дэномин+ацией
деноминациею|дэномин+ациею
деноминаций|дэномин+аций
деноминациям|дэномин+ациям
деноминациями|дэномин+ациями
деноминациях|дэномин+ациях
денонсация|дэнонс+ация
денонсации|дэнонс+ации
денонсацию|дэнонс+ацию
денонсацией|дэнонс+ацией
денонсациею|дэнонс+ациею
денонсаций|дэнонс+аций
денонсациям|дэнонс+ациям
денонсациями|дэнонс+ациями
денонсациях|дэнонс+ациях
дерма|д+эрма
дермы|д+эрмы
дерме|д+эрме
дерму|д+эрму
дермой|д+эрмой
дермою|д+эрмою
дерм|д+эрм
дермам|д+эрмам
дермами|д+эрмами
дермах|д+эрмах
десегрегация|дэсегрег+ация
десегрегации|дэсегрег+ации
десегрегацию|дэсегрег+ацию
десегрегацией|дэсегрег+ацией
десегрегациею|дэсегрег+ациею
десегрегаций|дэсегрег+аций
десегрегациям|дэсегрег+ациям
десегрегациями|дэсегрег+ациями
десегрегациях|дэсегрег+ациях
детектор|дэт+эктор
детектора|дэт+эктора
детектору|дэт+эктору
детектором|дэт+эктором
детекторе|дэт+экторе
детекторы|дэт+экторы
детекторов|дэт+экторов
детекторам|дэт+экторам
детекторами|дэт+экторами
детекторах|дэт+экторах
детерминизм|дэтэрмин+изм
детерминизма|дэтэрмин+изма
детерминизму|дэтэрмин+изму
детерминизмом|дэтэрмин+измом
детерминизме|дэтэрмин+изме
детерминизмы|дэтэрмин+измы
детерминизмов|дэтэрмин+измов
детерминизмам|дэтэрмин+измам
детерминизмами|дэтэрмин+измами
детерминизмах|дэтэрмин+измах
де-факто|дэ-ф+акто
дефлектор|дэфл+ектор
дефлектора|дэфл+ектора
дефлектору|дэфл+ектору
дефлектором|дэфл+ектором
дефлекторе|дэфл+екторе
дефлекторы|дэфл+екторы
дефлекторов|дэфл+екторов
дефлекторам|дэфл+екторам
дефлекторами|дэфл+екторами
дефлекторах|дэфл+екторах
дефляция|дэфл+яция
дефляции|дэфл+яции
дефляцию|дэфл+яцию
дефляцией|дэфл+яцией
дефляциею|дэфл+яциею
дефляций|дэфл+яций
дефляциям|дэфл+яциям
дефляциями|дэфл+яциями
дефляциях|дэфл+яциях
децибел|дэциб+ел
децибела|дэциб+ела
децибелу|дэциб+елу
децибелом|дэциб+елом
децибеле|дэциб+еле
децибелы|дэциб+елы
децибелов|дэциб+елов
децибелам|дэциб+елам
децибелами|дэциб+елами
децибелах|дэциб+елах
дециметр|дэцим+етр
дециметра|дэцим+етра
дециметру|дэцим+етру
дециметром|дэцим+етром
дециметре|дэцим+етре
дециметры|дэцим+етры
дециметров|дэцим+етров
дециметрового|дэцим+етрового
дециметровому|дэцим+етровому
дециметровым|дэцим+етровым
дециметровом|дэцим+етровом
дециметровая|дэцим+етровая
дециметровой|дэцим+етровой
дециметровую|дэцим+етровую
дециметровою|дэцим+етровою
дециметровое|дэцим+етровое
дециметровые|дэцим+етровые
дециметровых|дэцим+етровых
дециметровыми|дэцим+етровыми
дециметрова|дэцим+етрова
дециметрово|дэцим+етрово
дециметровы|дэцим+етровы
дециметровее|дэцим+етровее
дециметровей|дэцим+етровей
дециметрам|дэцим+етрам
дециметрами|дэцим+етрами
дециметрах|дэцим+етрах
деэскалация|дээскал+ация
деэскалации|дээскал+ации
деэскалацию|дээскал+ацию
деэскалацией|дээскал+ацией
деэскалациею|дээскал+ациею
деэскалаций|дээскал+аций
деэскалациям|дээскал+ациям
деэскалациями|дээскал+ациями
деэскалациях|дээскал+ациях
де-юре|дэ-+юрэ
индексация|индэкс+ация
индексации|индэкс+ации
индексацию|индэкс+ацию
индексацией|индэкс+ацией
индексациею|индэкс+ациею
индексаций|индэкс+аций
индексациям|индэкс+ациям
индексациями|индэкс+ациями
индексациях|индэкс+ациях
компьютер|компь+ютэр
компьютера|компь+ютэра
компьютеру|компь+ютэру
компьютером|компь+ютэром
компьютере|компь+ютэре
компьютеры|компь+ютэры
компьютеров|компь+ютэров
компьютерам|компь+ютэрам
компьютерами|компь+ютэрами
компьютерах|компь+ютэрах
конденсат|кондэнс+ат
конденсата|кондэнс+ата
конденсату|кондэнс+ату
конденсатом|кондэнс+атом
конденсате|кондэнс+ате
конденсаты|кондэнс+аты
конденсатов|кондэнс+атов
конденсатам|кондэнс+атам
конденсатами|кондэнс+атами
конденсатах|кондэнс+атах
конденсатор|кондэнс+атор
конденсатора|кондэнс+атора
конденсатору|кондэнс+атору
конденсатором|кондэнс+атором
конденсаторе|кондэнс+аторе
конденсаторы|кондэнс+аторы
конденсаторов|кондэнс+аторов
конденсаторам|кондэнс+аторам
конденсаторами|кондэнс+аторами
конденсаторах|кондэнс+аторах
консенсус|конс+энсус
консенсуса|конс+энсуса
консенсусу|конс+энсусу
консенсусом|конс+энсусом
консенсусе|конс+энсусе
консенсусы|конс+энсусы
консенсусов|конс+энсусов
консенсусам|конс+энсусам
консенсусами|конс+энсусами
консенсусах|конс+энсусах
конфиденциальный|конфидэнци+альный
конфиденциального|конфидэнци+ального
конфиденциальному|конфидэнци+альному
конфиденциальным|конфидэнци+альным
конфиденциальном|конфидэнци+альном
конфиденциальная|конфидэнци+альная
конфиденциальной|конфидэнци+альной
конфиденциальную|конфидэнци+альную
конфиденциальною|конфидэнци+альною
конфиденциальное|конфидэнци+альное
конфиденциальные|конфидэнци+альные
конфиденциальных|конфидэнци+альных
конфиденциальными|конфидэнци+альными
конфиденциален|конфидэнци+ален
конфиденциальна|конфидэнци+альна
конфиденциально|конфидэнци+ально
конфиденциальны|конфидэнци+альны
конфиденциальнее|конфидэнци+альнее
конфиденциальней|конфидэнци+альней
поконфиденциальнее|поконфидэнци+альнее
поконфиденциальней|поконфидэнци+альней
кордебалет|кордэбал+ет
кордебалета|кордэбал+ета
кордебалету|кордэбал+ету
кордебалетом|кордэбал+етом
кордебалете|кордэбал+ете
кордебалеты|кордэбал+еты
кордебалетов|кордэбал+етов
кордебалетам|кордэбал+етам
кордебалетами|кордэбал+етами
кордебалетах|кордэбал+етах
косеканс|кос+эканс
косеканса|кос+эканса
косекансу|кос+экансу
косекансом|кос+экансом
косекансе|кос+экансе
косекансы|кос+экансы
косекансов|кос+экансов
косекансам|кос+экансам
косекансами|кос+экансами
косекансах|кос+экансах
кратер|кр+атэр
кратера|кр+атэра
кратеру|кр+атэру
кратером|кр+атэром
кратере|кр+атэре
кратеры|кр+атэры
кратеров|кр+атэров
кратерам|кр+атэрам
кратерами|кр+атэрами
кратерах|кр+атэрах
кредо|кр+эдо
крепдешин|крэпдэш+ин
крепдешина|крэпдэш+ина
крепдешину|крэпдэш+ину
крепдешином|крэпдэш+ином
крепдешине|крэпдэш+ине
крепдешины|крэпдэш+ины
крепдешинов|крэпдэш+инов
крепдешинового|крэпдэш+инового
крепдешиновому|крэпдэш+иновому
крепдешиновым|крэпдэш+иновым
крепдешиновом|крэпдэш+иновом
крепдешиновая|крэпдэш+иновая
крепдешиновой|крэпдэш+иновой
крепдешиновую|крэпдэш+иновую
крепдешиновою|крэпдэш+иновою
крепдешиновое|крэпдэш+иновое
крепдешиновые|крэпдэш+иновые
крепдешиновых|крэпдэш+иновых
крепдешиновыми|крэпдэш+иновыми
крепдешинова|крэпдэш+инова
крепдешиново|крэпдэш+иново
крепдешиновы|крэпдэш+иновы
крепдешиновее|крэпдэш+иновее
крепдешиновей|крэпдэш+иновей
крепдешинам|крэпдэш+инам
крепдешинами|крэпдэш+инами
крепдешинах|крэпдэш+инах
лазер|л+азэр
лазера|л+азэра
лазеру|л+азэру
лазером|л+азэром
лазере|л+азэре
лазеры|л+азэры
лазеров|л+азэров
лазерам|л+азэрам
лазерами|л+азэрами
лазерах|л+азэрах
менеджер|м+энэджер
менеджера|м+энэджера
менеджеру|м+энэджеру
менеджером|м+энэджером
менеджере|м+энэджере
менеджеры|м+энэджеры
менеджеров|м+энэджеров
менеджерам|м+энэджерам
менеджерами|м+энэджерами
менеджерах|м+энэджерах
менеджмент|м+энэджмент
менеджмента|м+энэджмента
менеджменту|м+энэджменту
менеджментом|м+энэджментом
менеджменте|м+энэджменте
менеджменты|м+энэджменты
менеджментов|м+энэджментов
менеджментам|м+энэджментам
менеджментами|м+энэджментами
менеджментах|м+энэджментах
менестрель|менэстр+эль
менестреля|менэстр+эля
менестрелю|менэстр+элю
менестрелем|менэстр+элем
менестреле|менэстр+эле
менестрели|менэстр+эли
менестрелей|менэстр+элей
менестрелям|менэстр+элям
менестрелями|менэстр+элями
менестрелях|менэстр+элях
моделировать|модэл+ировать
моделирую|модэл+ирую
моделируем|модэл+ируем
моделируешь|модэл+ируешь
моделируете|модэл+ируете
моделирует|модэл+ирует
моделируют|модэл+ируют
моделировал|модэл+ировал
моделировала|модэл+ировала
моделировало|модэл+ировало
моделировали|модэл+ировали
моделируй|модэл+ируй
моделируйте|модэл+ируйте
моделирующий|модэл+ирующий
моделирующе|модэл+ирующе
моделирующего|модэл+ирующего
моделирующему|модэл+ирующему
моделирующим|модэл+ирующим
моделирующем|модэл+ирующем
моделирующая|модэл+ирующая
моделирующей|модэл+ирующей
моделирующую|модэл+ирующую
моделирующею|модэл+ирующею
моделирующее|модэл+ирующее
моделирующие|модэл+ирующие
моделирующих|модэл+ирующих
моделирующими|модэл+ирующими
моделировавший|модэл+ировавший
моделировавшего|модэл+ировавшего
моделировавшему|модэл+ировавшему
моделировавшим|модэл+ировавшим
моделировавшем|модэл+ировавшем
моделировавшая|модэл+ировавшая
моделировавшей|модэл+ировавшей
моделировавшую|модэл+ировавшую
моделировавшею|модэл+ировавшею
моделировавшее|модэл+ировавшее
моделировавшие|модэл+ировавшие
моделировавших|модэл+ировавших
моделировавшими|модэл+ировавшими
моделируемый|модэл+ируемый
моделируемого|модэл+ируемого
моделируемому|модэл+ируемому
моделируемым|модэл+ируемым
моделируемом|модэл+ируемом
моделируемая|модэл+ируемая
моделируемой|модэл+ируемой
моделируемую|модэл+ируемую
моделируемою|модэл+ируемою
моделируемое|модэл+ируемое
моделируемые|модэл+ируемые
моделируемых|модэл+ируемых
моделируемыми|модэл+ируемыми
моделированный|модэл+ированный
моделированного|модэл+ированного
моделированному|модэл+ированному
моделированным|модэл+ированным
моделированном|модэл+ированном
моделированная|модэл+ированная
моделированной|модэл+ированной
моделированную|модэл+ированную
моделированною|модэл+ированною
моделированное|модэл+ированное
моделированные|модэл+ированные
моделированных|модэл+ированных
моделированными|модэл+ированными
моделируя|модэл+ируя
моделировавши|модэл+ировавши
моделируема|модэл+ируема
моделируемо|модэл+ируемо
моделируемы|модэл+ируемы
моделирован|модэл+ирован
моделирована|модэл+ирована
моделировано|модэл+ировано
моделированы|модэл+ированы
нонсенс|н+онсэнс
нонсенса|н+онсэнса
нонсенсу|н+онсэнсу
нонсенсом|н+онсэнсом
нонсенсе|н+онсэнсе
нонсенсы|н+онсэнсы
нонсенсов|н+онсэнсов
нонсенсам|н+онсэнсам
нонсенсами|н+онсэнсами
нонсенсах|н+онсэнсах
орхидея|орхид+эя
орхидеи|орхид+эи
орхидее|орхид+эе
орхидею|орхид+эю
орхидеей|орхид+эей
орхидеею|орхид+эею
орхидей|орхид+эй
орхидеям|орхид+эям
орхидеями|орхид+эями
орхидеях|орхид+эях
пантеон|пантэ+он
пантеона|пантэ+она
пантеону|пантэ+ону
пантеоном|пантэ+оном
пантеоне|пантэ+оне
пантеоны|пантэ+оны
пантеонов|пантэ+онов
пантеонам|пантэ+онам
пантеонами|пантэ+онами
пантеонах|пантэ+онах
пантера|пант+эра
пантеры|пант+эры
пантере|пант+эре
пантеру|пант+эру
пантерой|пант+эрой
пантерою|пант+эрою
пантер|пант+эр
пантерам|пант+эрам
пантерами|пант+эрами
пантерах|пант+эрах
партер|парт+эр
партера|парт+эра
партеру|парт+эру
партером|парт+эром
партере|парт+эре
партеры|парт+эры
партеров|парт+эров
партерам|парт+эрам
партерами|парт+эрами
партерах|парт+эрах
пиетет|пиэт+ет
пиетета|пиэт+ета
пиетету|пиэт+ету
пиететом|пиэт+етом
пиетете|пиэт+ете
пиететы|пиэт+еты
пиететов|пиэт+етов
пиететам|пиэт+етам
пиететами|пиэт+етами
пиететах|пиэт+етах
претенциозный|претэнци+озный
претенциозного|претэнци+озного
претенциозному|претэнци+озному
претенциозным|претэнци+озным
претенциозном|претэнци+озном
претенциозная|претэнци+озная
претенциозной|претэнци+озной
претенциозную|претэнци+озную
претенциозною|претэнци+озною
претенциозное|претэнци+озное
претенциозные|претэнци+озные
претенциозных|претэнци+озных
претенциозными|претэнци+озными
претенциозен|претэнци+озен
претенциозна|претэнци+озна
претенциозно|претэнци+озно
претенциозны|претэнци+озны
претенциознее|претэнци+ознее
претенциозней|претэнци+озней
попретенциознее|попретэнци+ознее
попретенциозней|попретэнци+озней
провиденциальный|провидэнци+альный
провиденциального|провидэнци+ального
провиденциальному|провидэнци+альному
провиденциальным|провидэнци+альным
провиденциальном|провидэнци+альном
провиденциальная|провидэнци+альная
провиденциальной|провидэнци+альной
провиденциальную|провидэнци+альную
провиденциальною|провидэнци+альною
провиденциальное|провидэнци+альное
провиденциальные|провидэнци+альные
провиденциальных|провидэнци+альных
провиденциальными|провидэнци+альными
провиденциален|провидэнци+ален
провиденциальна|провидэнци+альна
провиденциально|провидэнци+ально
провиденциальны|провидэнци+альны
продюсер|прод+юсэр
продюсера|прод+юсэра
продюсеру|прод+юсэру
продюсером|прод+юсэром
продюсере|прод+юсэре
продюсеры|прод+юсэры
продюсеров|прод+юсэров
продюсерам|прод+юсэрам
продюсерами|прод+юсэрами
продюсерах|прод+юсэрах
протеже|протэж+е
протез|прот+эз
протеза|прот+эза
протезу|прот+эзу
протезом|прот+эзом
протезе|прот+эзе
протезы|прот+эзы
протезов|прот+эзов
протезам|прот+эзам
протезами|прот+эзами
протезах|прот+эзах
протекция|прот+экция
протекции|прот+экции
протекцию|прот+экцию
протекцией|прот+экцией
протекциею|прот+экциею
протекций|прот+экций
протекциям|прот+экциям
протекциями|прот+экциями
протекциях|прот+экциях
рандеву|рандэв+у
реквием|р+эквиэм
реквиема|р+эквиэма
реквиему|р+эквиэму
реквиемом|р+эквиэмом
реквиеме|р+эквиэме
реквиемы|р+эквиэмы
реквиемов|р+эквиэмов
реквиемам|р+эквиэмам
реквиемами|р+эквиэмами
реквиемах|р+эквиэмах
реноме|рэном+э
резюме|резюм+э
секанс|с+эканс
секанса|с+эканса
секансу|с+экансу
секансом|с+экансом
секансе|с+экансе
секансы|с+экансы
секансов|с+экансов
секансам|с+экансам
секансами|с+экансами
секансах|с+экансах
сенбернар|сэнберн+ар
сенбернара|сэнберн+ара
сенбернару|сэнберн+ару
сенбернаром|сэнберн+аром
сенбернаре|сэнберн+аре
сенбернары|сэнберн+ары
сенбернаров|сэнберн+аров
сенбернарам|сэнберн+арам
сенбернарами|сэнберн+арами
сенбернарах|сэнберн+арах
сентенция|сэнт+энция
сентенции|сэнт+энции
сентенцию|сэнт+энцию
сентенцией|сэнт+энцией
сентенциею|сэнт+энциею
сентенций|сэнт+энций
сентенциям|сэнт+энциям
сентенциями|сэнт+энциями
сентенциях|сэнт+энциях
сепсис|с+эпсис
сепсиса|с+эпсиса
сепсису|с+эпсису
сепсисом|с+эпсисом
сепсисе|с+эпсисе
сепсисы|с+эпсисы
сепсисов|с+эпсисов
сепсисам|с+эпсисам
сепсисами|с+эпсисами
сепсисах|с+эпсисах
сеттер|с+эттэр
сеттера|с+эттэра
сеттеру|с+эттэру
сеттером|с+эттэром
сеттере|с+эттэре
сеттеры|с+эттэры
сеттеров|с+эттэров
сеттерам|с+эттэрам
сеттерами|с+эттэрами
сеттерах|с+эттэрах
синтез|с+интэз
синтеза|с+интэза
синтезу|с+интэзу
синтезом|с+интэзом
синтезе|с+интэзе
синтезы|с+интэзы
синтезов|с+интэзов
синтезам|с+интэзам
синтезами|с+интэзами
синтезах|с+интэзах
сонет|сон+эт
сонета|сон+эта
сонету|сон+эту
сонетом|сон+этом
сонете|сон+эте
сонеты|сон+эты
сонетов|сон+этов
сонетам|сон+этам
сонетами|сон+этами
сонетах|сон+этах
стресс|стр+эсс
стресса|стр+эсса
стрессу|стр+эссу
стрессом|стр+эссом
стрессе|стр+эссе
стрессы|стр+эссы
стрессов|стр+эссов
стрессам|стр+эссам
стрессами|стр+эссами
стрессах|стр+эссах
теза|т+эза
тезы|т+эзы
тезе|т+эзе
тезу|т+эзу
тезой|т+эзой
тезою|т+эзою
тез|т+эз
тезам|т+эзам
тезами|т+эзами
тезах|т+эзах
антитеза|антит+эза
антитезы|антит+эзы
антитезе|антит+эзе
антитезу|антит+эзу
антитезой|антит+эзой
антитезою|антит+эзою
антитез|антит+эз
антитезам|антит+эзам
антитезами|антит+эзами
антитезах|антит+эзах
тезаурус|тэз+аурус
тезауруса|тэз+ауруса
тезаурусу|тэз+аурусу
тезаурусом|тэз+аурусом
тезаурусе|тэз+аурусе
тезаурусы|тэз+аурусы
тезаурусов|тэз+аурусов
тезаурусам|тэз+аурусам
тезаурусами|тэз+аурусами
тезаурусах|тэз+аурусах
тезис|т+эзис
тезиса|т+эзиса
тезису|т+эзису
тезисом|т+эзисом
тезисе|т+эзисе
тезисы|т+эзисы
тезисов|т+эзисов
тезисам|т+эзисам
тезисами|т+эзисами
тезисах|т+эзисах
антитезис|антит+эзис
антитезиса|антит+эзиса
антитезису|антит+эзису
антитезисом|антит+эзисом
антитезисе|антит+эзисе
антитезисы|антит+эзисы
антитезисов|антит+эзисов
антитезисам|антит+эзисам
антитезисами|антит+эзисами
антитезисах|антит+эзисах
тембр|т+эмбр
тембра|т+эмбра
тембру|т+эмбру
тембром|т+эмбром
тембре|т+эмбре
тембры|т+эмбры
тембров|т+эмбров
тембрового|т+эмбрового
тембровому|т+эмбровому
тембровым|т+эмбровым
тембровом|т+эмбровом
тембровая|т+эмбровая
тембровой|т+эмбровой
тембровую|т+эмбровую
тембровою|т+эмбровою
тембровое|т+эмбровое
тембровые|т+эмбровые
тембровых|т+эмбровых
тембровыми|т+эмбровыми
темброва|т+эмброва
темброво|т+эмброво
тембровы|т+эмбровы
тембровее|т+эмбровее
тембровей|т+эмбровей
тембрам|т+эмбрам
тембрами|т+эмбрами
тембрах|т+эмбрах
темпера|т+эмпера
темперы|т+эмперы
темпере|т+эмпере
темперу|т+эмперу
темперой|т+эмперой
темперою|т+эмперою
темпер|т+эмпер
темперам|т+эмперам
темперами|т+эмперами
темперах|т+эмперах
тенденция|тэнд+энция
тенденции|тэнд+энции
тенденцию|тэнд+энцию
тенденцией|тэнд+энцией
тенденциею|тэнд+энциею
тенденций|тэнд+энций
тенденциям|тэнд+энциям
тенденциями|тэнд+энциями
тенденциях|тэнд+энциях
тендер|т+эндэр
тендера|т+эндэра
тендеру|т+эндэру
тендером|т+эндэром
тендере|т+эндэре
тендеры|т+эндэры
тендеров|т+эндэров
тендерам|т+эндэрам
тендерами|т+эндэрами
тендерах|т+эндэрах
теннис|т+эннис
тенниса|т+энниса
теннису|т+эннису
теннисом|т+эннисом
теннисе|т+эннисе
теннисы|т+эннисы
теннисов|т+эннисов
теннисам|т+эннисам
теннисами|т+эннисами
теннисах|т+эннисах
тенниска|т+энниска
тенниски|т+энниски
тенниске|т+энниске
тенниску|т+энниску
тенниской|т+энниской
теннискою|т+эннискою
теннисок|т+эннисок
теннискам|т+эннискам
теннисками|т+эннисками
теннисках|т+эннисках
термос|т+эрмос
термоса|т+эрмоса
термосу|т+эрмосу
термосом|т+эрмосом
термосе|т+эрмосе
термосы|т+эрмосы
термосов|т+эрмосов
термосам|т+эрмосам
термосами|т+эрмосами
термосах|т+эрмосах
термы|т+эрмы
терм|т+эрм
термам|т+эрмам
термами|т+эрмами
термах|т+эрмах
терракота|тэррак+ота
терракоты|тэррак+оты
терракоте|тэррак+оте
терракоту|тэррак+оту
терракотой|тэррак+отой
терракотою|тэррак+отою
терракот|тэррак+от
терракотам|тэррак+отам
терракотами|тэррак+отами
терракотах|тэррак+отах
терция|т+эрция
терции|т+эрции
терцию|т+эрцию
терцией|т+эрцией
терциею|т+эрциею
терций|т+эрций
терциям|т+эрциям
терциями|т+эрциями
терциях|т+эрциях
тет-а-тет|тэт-а-т+эт
тетраэдр|тэтр+аэдр
тетраэдра|тэтр+аэдра
тетраэдру|тэтр+аэдру
тетраэдром|тэтр+аэдром
тетраэдре|тэтр+аэдре
тетраэдры|тэтр+аэдры
тетраэдров|тэтр+аэдров
тетраэдрам|тэтр+аэдрам
тетраэдрами|тэтр+аэдрами
тетраэдрах|тэтр+аэдрах
трек|тр+эк
трека|тр+эка
треку|тр+эку
треком|тр+эком
треке|тр+эке
треки|тр+эки
треков|тр+эков
трекам|тр+экам
треками|тр+эками
треках|тр+эках
фонема|фон+эма
фонемы|фон+эмы
фонеме|фон+эме
фонему|фон+эму
фонемой|фон+эмой
фонемою|фон+эмою
фонем|фон+эм
фонемам|фон+эмам
фонемами|фон+эмами
фонемах|фон+эмах
фонетика|фон+этика
фонетики|фон+этики
фонетике|фон+этике
фонетику|фон+этику
фонетикой|фон+этикой
фонетикою|фон+этикою
фонетик|фон+этик
фонетикам|фон+этикам
фонетиками|фон+этиками
фонетиках|фон+этиках
фрейлина|фр+эйлина
фрейлины|фр+эйлины
фрейлине|фр+эйлине
фрейлину|фр+эйлину
фрейлиной|фр+эйлиной
фрейлиною|фр+эйлиною
фрейлин|фр+эйлин
фрейлинам|фр+эйлинам
фрейлинами|фр+эйлинами
фрейлинах|фр+эйлинах
фрикаделька|фрикад+элька
фрикадельки|фрикад+эльки
фрикадельке|фрикад+эльке
фрикадельку|фрикад+эльку
фрикаделькой|фрикад+элькой
фрикаделькою|фрикад+элькою
фрикаделек|фрикад+элек
фрикаделькам|фрикад+элькам
фрикадельками|фрикад+эльками
фрикадельках|фрикад+эльках
чичероне|чичер+онэ
шоумен|шоум+эн
шоумена|шоум+эна
шоумену|шоум+эну
шоуменом|шоум+эном
шоумене|шоум+эне
шоумены|шоум+эны
шоуменов|шоум+энов
шоуменам|шоум+энам
шоуменами|шоум+энами
шоуменах|шоум+энах
экстрасенс|экстрас+энс
экстрасенса|экстрас+энса
экстрасенсу|экстрас+энсу
экстрасенсом|экстрас+энсом
экстрасенсе|экстрас+энсе
экстрасенсы|экстрас+энсы
экстрасенсов|экстрас+энсов
экстрасенсам|экстрас+энсам
экстрасенсами|экстрас+энсами
экстрасенсах|экстрас+энсах
анестезия|анэстэз+ия
анестезии|анэстэз+ии
анестезию|анэстэз+ию
анестезией|анэстэз+ией
анестезиею|анэстэз+иею
анестезий|анэстэз+ий
анестезиям|анэстэз+иям
анестезиями|анэстэз+иями
анестезиях|анэстэз+иях
бизнесмен|бизнэсм+эн
бизнесмена|бизнэсм+эна
бизнесмену|бизнэсм+эну
бизнесменом|бизнэсм+эном
бизнесмене|бизнэсм+эне
бизнесмены|бизнэсм+эны
бизнесменов|бизнэсм+энов
бизнесменам|бизнэсм+энам
бизнесменами|бизнэсм+энами
бизнесменах|бизнэсм+энах
дезабилье|дэзаб+илье
дезинтеграция|дэзинтэгр+ация
дезинтеграции|дэзинтэгр+ации
дезинтеграцию|дэзинтэгр+ацию
дезинтеграцией|дэзинтэгр+ацией
дезинтеграциею|дэзинтэгр+ациею
дезинтеграций|дэзинтэгр+аций
дезинтеграциям|дэзинтэгр+ациям
дезинтеграциями|дэзинтэгр+ациями
дезинтеграциях|дэзинтэгр+ациях
дезинформация|дэзинформ+ация
дезинформации|дэзинформ+ации
дезинформацию|дэзинформ+ацию
дезинформацией|дэзинформ+ацией
дезинформациею|дэзинформ+ациею
дезинформаций|дэзинформ+аций
дезинформациям|дэзинформ+ациям
дезинформациями|дэзинформ+ациями
дезинформациях|дэзинформ+ациях
дезориентация|дэзориент+ация
дезориентации|дэзориент+ации
дезориентацию|дэзориент+ацию
дезориентацией|дэзориент+ацией
дезориентациею|дэзориент+ациею
дезориентаций|дэзориент+аций
дезориентациям|дэзориент+ациям
дезориентациями|дэзориент+ациями
дезориентациях|дэзориент+ациях
терцет|тэрц+эт
терцета|тэрц+эта
терцету|тэрц+эту
терцетом|тэрц+этом
терцете|тэрц+эте
терцеты|тэрц+эты
терцетов|тэрц+этов
терцетам|тэрц+этам
терцетами|тэрц+этами
терцетах|тэрц+этах
адептка|ад+эптка
адептки|ад+эптки
адептке|ад+эптке
адептку|ад+эптку
адепткой|ад+эпткой
адепткою|ад+эпткою
адепток|ад+эпток
адепткам|ад+эпткам
адептками|ад+эптками
адептках|ад+эптках
адепткий|ад+эпткий
адепткого|ад+эпткого
адепткому|ад+эпткому
адептким|ад+эптким
адептком|ад+эптком
адепткая|ад+эпткая
адепткую|ад+эпткую
адепткое|ад+эпткое
адепткие|ад+эпткие
адептких|ад+эптких
адепткими|ад+эпткими
адептко|ад+эптко
адептче|ад+эптче
детективный|дэтэкт+ивный
детективном|дэтэкт+ивном
детективной|дэтэкт+ивной
детективную|дэтэкт+ивную
детективною|дэтэкт+ивною
детективных|дэтэкт+ивных
детективен|дэтэкт+ивен
детективна|дэтэкт+ивна
детективно|дэтэкт+ивно
детективны|дэтэкт+ивны
детективнее|дэтэкт+ивнее
детективней|дэтэкт+ивней
детективчик|дэтэкт+ивчик
детективчика|дэтэкт+ивчика
детективчику|дэтэкт+ивчику
детективчиком|дэтэкт+ивчиком
детективчике|дэтэкт+ивчике
детективчиков|дэтэкт+ивчиков
детективчикам|дэтэкт+ивчикам
детективчиками|дэтэкт+ивчиками
детективчиках|дэтэкт+ивчиках
детективная|дэтэкт+ивная
детективное|дэтэкт+ивное
детективчики|дэтэкт+ивчики
детективного|дэтэкт+ивного
детективным|дэтэкт+ивным
детективными|дэтэкт+ивными
детективные|дэтэкт+ивные
детективному|дэтэкт+ивному
адекватность|адэкв+атность
адекватностью|адэкв+атностью
адекватностей|адэкв+атностей
адекватностях|адэкв+атностях
адекватности|адэкв+атности
адекватностям|адэкв+атностям
адекватностями|адэкв+атностями
неадекватно|неадэкв+атно
неадекватного|неадэкв+атного
неадекватному|неадэкв+атному
неадекватным|неадэкв+атным
неадекватном|неадэкв+атном
неадекватная|неадэкв+атная
неадекватной|неадэкв+атной
неадекватную|неадэкв+атную
неадекватною|неадэкв+атною
неадекватное|неадэкв+атное
неадекватные|неадэкв+атные
неадекватных|неадэкв+атных
неадекватными|неадэкв+атными
неадекватен|неадэкв+атен
неадекватна|неадэкв+атна
неадекватны|неадэкв+атны
неадекватный|неадэкв+атный
аннексионизм|аннэксион+изм
аннексионизме|аннэксион+изме
аннексионизмы|аннэксион+измы
аннексионизмов|аннэксион+измов
аннексионизмам|аннэксион+измам
аннексионизмами|аннэксион+измами
аннексионизмах|аннэксион+измах
аннексионизма|аннэксион+изма
аннексионизму|аннэксион+изму
аннексионизмом|аннэксион+измом
аннексионист|аннэксион+ист
аннексиониста|аннэксион+иста
аннексионисту|аннэксион+исту
аннексионисте|аннэксион+исте
аннексионистов|аннэксион+истов
аннексионистах|аннэксион+истах
аннексионистка|аннэксион+истка
аннексионистки|аннэксион+истки
аннексионистке|аннэксион+истке
аннексионистку|аннэксион+истку
аннексионисткой|аннэксион+исткой
аннексионисткою|аннэксион+исткою
аннексионисток|аннэксион+исток
аннексионисткам|аннэксион+исткам
аннексионистками|аннэксион+истками
аннексионистках|аннэксион+истках
аннексионисты|аннэксион+исты
аннексионистом|аннэксион+истом
аннексионистами|аннэксион+истами
аннексионистам|аннэксион+истам
аннексирование|аннэкс+ирование
аннексированье|аннэкс+ированье
аннексированья|аннэкс+ированья
аннексированию|аннэкс+ированию
аннексированью|аннэкс+ированью
аннексированьем|аннэкс+ированьем
аннексировании|аннэкс+ировании
аннексирования|аннэкс+ирования
аннексированием|аннэкс+ированием
аннексированьи|аннэкс+ированьи
аннексирований|аннэкс+ирований
аннексированиям|аннэкс+ированиям
аннексированьям|аннэкс+ированьям
аннексированиями|аннэкс+ированиями
аннексированьями|аннэкс+ированьями
аннексированиях|аннэкс+ированиях
аннексированьях|аннэкс+ированьях
аннексировать|аннэкс+ировать
аннексировало|аннэкс+ировало
аннексируешь|аннэкс+ируешь
аннексируете|аннэкс+ируете
аннексируемте|аннэкс+ируемте
аннексируй|аннэкс+ируй
аннексируйте|аннэкс+ируйте
аннексировавший|аннэкс+ировавший
аннексировавшего|аннэкс+ировавшего
аннексировавшему|аннэкс+ировавшему
аннексировавшим|аннэкс+ировавшим
аннексировавшем|аннэкс+ировавшем
аннексировавшая|аннэкс+ировавшая
аннексировавшей|аннэкс+ировавшей
аннексировавшую|аннэкс+ировавшую
аннексировавшею|аннэкс+ировавшею
аннексировавшее|аннэкс+ировавшее
аннексировавшие|аннэкс+ировавшие
аннексировавших|аннэкс+ировавших
аннексировавшими|аннэкс+ировавшими
аннексированный|аннэкс+ированный
аннексированного|аннэкс+ированного
аннексированному|аннэкс+ированному
аннексированным|аннэкс+ированным
аннексированном|аннэкс+ированном
аннексированная|аннэкс+ированная
аннексированной|аннэкс+ированной
аннексированную|аннэкс+ированную
аннексированною|аннэкс+ированною
аннексированное|аннэкс+ированное
аннексированные|аннэкс+ированные
аннексированных|аннэкс+ированных
аннексированными|аннэкс+ированными
аннексировав|аннэкс+ировав
аннексировавши|аннэкс+ировавши
аннексирующий|аннэкс+ирующий
аннексирующего|аннэкс+ирующего
аннексирующему|аннэкс+ирующему
аннексирующим|аннэкс+ирующим
аннексирующем|аннэкс+ирующем
аннексирующая|аннэкс+ирующая
аннексирующей|аннэкс+ирующей
аннексирующую|аннэкс+ирующую
аннексирующею|аннэкс+ирующею
аннексирующее|аннэкс+ирующее
аннексирующие|аннэкс+ирующие
аннексирующих|аннэкс+ирующих
аннексирующими|аннэкс+ирующими
аннексируемый|аннэкс+ируемый
аннексируемого|аннэкс+ируемого
аннексируемому|аннэкс+ируемому
аннексируемым|аннэкс+ируемым
аннексируемом|аннэкс+ируемом
аннексируемая|аннэкс+ируемая
аннексируемой|аннэкс+ируемой
аннексируемую|аннэкс+ируемую
аннексируемою|аннэкс+ируемою
аннексируемое|аннэкс+ируемое
аннексируемые|аннэкс+ируемые
аннексируемых|аннэкс+ируемых
аннексируемыми|аннэкс+ируемыми
аннексируя|аннэкс+ируя
аннексируема|аннэкс+ируема
аннексируемо|аннэкс+ируемо
аннексируемы|аннэкс+ируемы
аннексирован|аннэкс+ирован
аннексирована|аннэкс+ирована
аннексировано|аннэкс+ировано
аннексированы|аннэкс+ированы
аннексировали|аннэкс+ировали
аннексировал|аннэкс+ировал
аннексировала|аннэкс+ировала
аннексируют|аннэкс+ируют
аннексирует|аннэкс+ирует
аннексирую|аннэкс+ирую
аннексируем|аннэкс+ируем
аннексироваться|аннэкс+ироваться
аннексируюсь|аннэкс+ируюсь
аннексируемся|аннэкс+ируемся
аннексируешься|аннэкс+ируешься
аннексируетесь|аннэкс+ируетесь
аннексируется|аннэкс+ируется
аннексируются|аннэкс+ируются
аннексировался|аннэкс+ировался
аннексировалась|аннэкс+ировалась
аннексировалось|аннэкс+ировалось
аннексировались|аннэкс+ировались
аннексируйся|аннэкс+ируйся
аннексируйтесь|аннэкс+ируйтесь
аннексирующийся|аннэкс+ирующийся
аннексирующегося|аннэкс+ирующегося
аннексирующемуся|аннэкс+ирующемуся
аннексирующимся|аннэкс+ирующимся
аннексирующемся|аннэкс+ирующемся
аннексирующаяся|аннэкс+ирующаяся
аннексирующейся|аннэкс+ирующейся
аннексирующуюся|аннэкс+ирующуюся
аннексирующеюся|аннэкс+ирующеюся
аннексирующееся|аннэкс+ирующееся
аннексирующиеся|аннэкс+ирующиеся
аннексирующихся|аннэкс+ирующихся
аннексирующимися|аннэкс+ирующимися
аннексировавшийся|аннэкс+ировавшийся
аннексировавшегося|аннэкс+ировавшегося
аннексировавшемуся|аннэкс+ировавшемуся
аннексировавшимся|аннэкс+ировавшимся
аннексировавшемся|аннэкс+ировавшемся
аннексировавшаяся|аннэкс+ировавшаяся
аннексировавшейся|аннэкс+ировавшейся
аннексировавшуюся|аннэкс+ировавшуюся
аннексировавшеюся|аннэкс+ировавшеюся
аннексировавшееся|аннэкс+ировавшееся
аннексировавшиеся|аннэкс+ировавшиеся
аннексировавшихся|аннэкс+ировавшихся
аннексировавшимися|аннэкс+ировавшимися
аннексируясь|аннэкс+ируясь
аннексировавшись|аннэкс+ировавшись
антисептический|антисэпт+ический
антисептическом|антисэпт+ическом
антисептической|антисэпт+ической
антисептическую|антисэпт+ическую
антисептическою|антисэпт+ическою
антисептическое|антисэпт+ическое
антисептических|антисэпт+ических
антисептического|антисэпт+ического
антисептическому|антисэпт+ическому
антисептическими|антисэпт+ическими
антисептическим|антисэпт+ическим
антисептическая|антисэпт+ическая
антисептические|антисэпт+ические
антисептически|антисэпт+ически
антисептичёска|антисэпт+ичёска
антисептичёски|антисэпт+ичёски
антисептичёске|антисэпт+ичёске
антисептичёску|антисэпт+ичёску
антисептичёской|антисэпт+ичёской
антисептичёскою|антисэпт+ичёскою
антисептичёсок|антисэпт+ичёсок
антисептичёскам|антисэпт+ичёскам
антисептичёсками|антисэпт+ичёсками
антисептичёсках|антисэпт+ичёсках
антисептическа|антисэпт+ическа
антисептическе|антисэпт+ическе
антисептическу|антисэпт+ическу
антисептичесок|антисэпт+ичесок
антисептическам|антисэпт+ическам
антисептическами|антисэпт+ическами
антисептическах|антисэпт+ическах
антисептическ|антисэпт+ическ
антисептическов|антисэпт+ическов
септический|сэпт+ический
септическом|сэпт+ическом
септическая|сэпт+ическая
септической|сэпт+ической
септическую|сэпт+ическую
септическою|сэпт+ическою
септическое|сэпт+ическое
септических|сэпт+ических
септического|сэпт+ического
септические|сэпт+ические
септическими|сэпт+ическими
септическим|сэпт+ическим
септическому|сэпт+ическому
септик|с+эптик
септика|с+эптика
септику|с+эптику
септике|с+эптике
септиков|с+эптиков
септикам|с+эптикам
септиках|с+эптиках
септики|с+эптики
септиком|с+эптиком
септиками|с+эптиками
антисептирование|антисэпт+ирование
антисептированье|антисэпт+ированье
антисептирования|антисэпт+ирования
антисептированья|антисэпт+ированья
антисептированию|антисэпт+ированию
антисептированью|антисэпт+ированью
антисептированьем|антисэпт+ированьем
антисептировании|антисэпт+ировании
антисептированием|антисэпт+ированием
антисептированьи|антисэпт+ированьи
антисептирований|антисэпт+ирований
антисептированиям|антисэпт+ированиям
антисептированьям|антисэпт+ированьям
антисептированиями|антисэпт+ированиями
антисептированьями|антисэпт+ированьями
антисептированиях|антисэпт+ированиях
антисептированьях|антисэпт+ированьях
атеистически|атэист+ически
атеистичёска|атэист+ичёска
атеистичёски|атэист+ичёски
атеистичёске|атэист+ичёске
атеистичёску|атэист+ичёску
атеистичёской|атэист+ичёской
атеистичёскою|атэист+ичёскою
атеистичёсок|атэист+ичёсок
атеистичёскам|атэист+ичёскам
атеистичёсками|атэист+ичёсками
атеистичёсках|атэист+ичёсках
атеистическа|атэист+ическа
атеистическе|атэист+ическе
атеистическу|атэист+ическу
атеистической|атэист+ической
атеистическою|атэист+ическою
атеистичесок|атэист+ичесок
атеистическам|атэист+ическам
атеистическами|атэист+ическами
атеистическах|атэист+ическах
атеистическ|атэист+ическ
атеистическом|атэист+ическом
атеистическов|атэист+ическов
атеистический|атэист+ический
атеистическим|атэист+ическим
атеистическая|атэист+ическая
атеистическую|атэист+ическую
атеистическое|атэист+ическое
атеистических|атэист+ических
атеистическому|атэист+ическому
атеистические|атэист+ические
атеистического|атэист+ического
атеистическими|атэист+ическими
атеистично|атэист+ично
атеистичному|атэист+ичному
атеистичном|атэист+ичном
атеистичная|атэист+ичная
атеистичной|атэист+ичной
атеистичную|атэист+ичную
атеистичною|атэист+ичною
атеистичное|атэист+ичное
атеистичные|атэист+ичные
атеистичных|атэист+ичных
атеистичен|атэист+ичен
атеистична|атэист+ична
атеистичны|атэист+ичны
атеистичнее|атэист+ичнее
атеистичней|атэист+ичней
атеистичный|атэист+ичный
атеистичного|атэист+ичного
атеистичными|атэист+ичными
атеистичным|атэист+ичным
атеистка|атэ+истка
атеистки|атэ+истки
атеистке|атэ+истке
атеистку|атэ+истку
атеисткой|атэ+исткой
атеисткою|атэ+исткою
атеисток|атэ+исток
атеисткам|атэ+исткам
атеистками|атэ+истками
атеистках|атэ+истках
монотеизм|монотэ+изм
монотеизму|монотэ+изму
монотеизме|монотэ+изме
монотеизмы|монотэ+измы
монотеизмов|монотэ+измов
монотеизмам|монотэ+измам
монотеизмами|монотэ+измами
монотеизмах|монотэ+измах
монотеизмом|монотэ+измом
монотеизма|монотэ+изма
монотеист|монотэ+ист
монотеиста|монотэ+иста
монотеисту|монотэ+исту
монотеистом|монотэ+истом
монотеисте|монотэ+исте
монотеистам|монотэ+истам
монотеистах|монотэ+истах
монотеисты|монотэ+исты
монотеистами|монотэ+истами
монотеистов|монотэ+истов
монотеистка|монотэ+истка
монотеистки|монотэ+истки
монотеистке|монотэ+истке
монотеистку|монотэ+истку
монотеисткой|монотэ+исткой
монотеисткою|монотэ+исткою
монотеисток|монотэ+исток
монотеисткам|монотэ+исткам
монотеистками|монотэ+истками
монотеистках|монотэ+истках
теолог|тэ+олог
теолога|тэ+олога
теологу|тэ+ологу
теологом|тэ+ологом
теологе|тэ+ологе
теологи|тэ+ологи
теологов|тэ+ологов
теологам|тэ+ологам
теологами|тэ+ологами
теологах|тэ+ологах
теология|тэ+ология
теологии|тэ+ологии
теологию|тэ+ологию
теологиею|тэ+ологиею
теологий|тэ+ологий
теологиям|тэ+ологиям
теологиями|тэ+ологиями
теологиях|тэ+ологиях
теологией|тэ+ологией
теократический|тэократ+ический
теократического|тэократ+ического
теократическому|тэократ+ическому
теократическом|тэократ+ическом
теократической|тэократ+ической
теократическую|тэократ+ическую
теократическою|тэократ+ическою
теократические|тэократ+ические
теократических|тэократ+ических
теократическим|тэократ+ическим
теократическая|тэократ+ическая
теократическими|тэократ+ическими
теократическое|тэократ+ическое
теократия|тэокр+атия
теократии|тэокр+атии
теократию|тэокр+атию
теократией|тэокр+атией
теократиею|тэокр+атиею
теократий|тэокр+атий
теократиям|тэокр+атиям
теократиями|тэокр+атиями
теократиях|тэокр+атиях
теологический|тэолог+ический
теологического|тэолог+ического
теологическому|тэолог+ическому
теологическим|тэолог+ическим
теологическом|тэолог+ическом
теологическая|тэолог+ическая
теологической|тэолог+ической
теологическую|тэолог+ическую
теологическою|тэолог+ическою
теологическое|тэолог+ическое
теологические|тэолог+ические
теологических|тэолог+ических
теологическими|тэолог+ическими
гротесковость|грот+эсковость
гротесковости|грот+эсковости
гротесковостью|грот+эсковостью
гротесковостей|грот+эсковостей
гротесковостям|грот+эсковостям
гротесковостями|грот+эсковостями
гротесковостях|грот+эсковостях
гротесковостить|грот+эсковостить
гротесковощу|грот+эсковощу
гротесковостим|грот+эсковостим
гротесковостишь|грот+эсковостишь
гротесковостите|грот+эсковостите
гротесковостит|грот+эсковостит
гротесковостят|грот+эсковостят
гротесковостил|грот+эсковостил
гротесковостила|грот+эсковостила
гротесковостило|грот+эсковостило
гротесковостили|грот+эсковостили
гротесковостьте|грот+эсковостьте
гротесковостящий|грот+эсковостящий
гротесковостящего|грот+эсковостящего
гротесковостящему|грот+эсковостящему
гротесковостящим|грот+эсковостящим
гротесковостящем|грот+эсковостящем
гротесковостящая|грот+эсковостящая
гротесковостящей|грот+эсковостящей
гротесковостящую|грот+эсковостящую
гротесковостящею|грот+эсковостящею
гротесковостящее|грот+эсковостящее
гротесковостящие|грот+эсковостящие
гротесковостящих|грот+эсковостящих
гротесковостящими|грот+эсковостящими
гротесковостивший|грот+эсковостивший
гротесковостившего|грот+эсковостившего
гротесковостившему|грот+эсковостившему
гротесковостившим|грот+эсковостившим
гротесковостившем|грот+эсковостившем
гротесковостившая|грот+эсковостившая
гротесковостившей|грот+эсковостившей
гротесковостившую|грот+эсковостившую
гротесковостившею|грот+эсковостившею
гротесковостившее|грот+эсковостившее
гротесковостившие|грот+эсковостившие
гротесковостивших|грот+эсковостивших
гротесковостившими|грот+эсковостившими
гротесковостимый|грот+эсковостимый
гротесковостимого|грот+эсковостимого
гротесковостимому|грот+эсковостимому
гротесковостимым|грот+эсковостимым
гротесковостимом|грот+эсковостимом
гротесковостимая|грот+эсковостимая
гротесковостимой|грот+эсковостимой
гротесковостимую|грот+эсковостимую
гротесковостимою|грот+эсковостимою
гротесковостимое|грот+эсковостимое
гротесковостимые|грот+эсковостимые
гротесковостимых|грот+эсковостимых
гротесковостимыми|грот+эсковостимыми
гротесковощенный|грот+эсковощенный
гротесковощенного|грот+эсковощенного
гротесковощенному|грот+эсковощенному
гротесковощенным|грот+эсковощенным
гротесковощенном|грот+эсковощенном
гротесковощенная|грот+эсковощенная
гротесковощенной|грот+эсковощенной
гротесковощенную|грот+эсковощенную
гротесковощенною|грот+эсковощенною
гротесковощенное|грот+эсковощенное
гротесковощенные|грот+эсковощенные
гротесковощенных|грот+эсковощенных
гротесковощенными|грот+эсковощенными
гротесковостя|грот+эсковостя
гротесковостив|грот+эсковостив
гротесковостивши|грот+эсковостивши
гротесковостима|грот+эсковостима
гротесковостимо|грот+эсковостимо
гротесковостимы|грот+эсковостимы
гротесковощен|грот+эсковощен
гротесковощена|грот+эсковощена
гротесковощено|грот+эсковощено
гротесковощены|грот+эсковощены
гротесковый|грот+эсковый
гротескный|грот+эскный
гротескного|грот+эскного
гротескному|грот+эскному
гротескным|грот+эскным
гротескном|грот+эскном
гротескная|грот+эскная
гротескной|грот+эскной
гротескную|грот+эскную
гротескною|грот+эскною
гротескное|грот+эскное
гротескные|грот+эскные
гротескных|грот+эскных
гротескными|грот+эскными
гротескна|грот+эскна
гротескно|грот+эскно
гротескны|грот+эскны
гротескнее|грот+эскнее
гротескней|грот+эскней
девальвационный|дэвальваци+онный
девальвационного|дэвальваци+онного
девальвационному|дэвальваци+онному
девальвационным|дэвальваци+онным
девальвационном|дэвальваци+онном
девальвационная|дэвальваци+онная
девальвационной|дэвальваци+онной
девальвационную|дэвальваци+онную
девальвационною|дэвальваци+онною
девальвационное|дэвальваци+онное
девальвационные|дэвальваци+онные
девальвационных|дэвальваци+онных
девальвационными|дэвальваци+онными
девальвированный|девальв+ированный
девальвировал|девальв+ировал
девальвировала|девальв+ировала
девальвировало|девальв+ировало
девальвировали|девальв+ировали
девальвирую|девальв+ирую
девальвируем|девальв+ируем
девальвируешь|девальв+ируешь
девальвируете|девальв+ируете
девальвирует|девальв+ирует
девальвируют|девальв+ируют
девальвируемте|девальв+ируемте
девальвируй|девальв+ируй
девальвируйте|девальв+ируйте
девальвировавший|девальв+ировавший
девальвировавшего|девальв+ировавшего
девальвировавшему|девальв+ировавшему
девальвировавшим|девальв+ировавшим
девальвировавшем|девальв+ировавшем
девальвировавшая|девальв+ировавшая
девальвировавшей|девальв+ировавшей
девальвировавшую|девальв+ировавшую
девальвировавшею|девальв+ировавшею
девальвировавшее|девальв+ировавшее
девальвировавшие|девальв+ировавшие
девальвировавших|девальв+ировавших
девальвировавшими|девальв+ировавшими
девальвированного|девальв+ированного
девальвированному|девальв+ированному
девальвированным|девальв+ированным
девальвированном|девальв+ированном
девальвированная|девальв+ированная
девальвированной|девальв+ированной
девальвированную|девальв+ированную
девальвированною|девальв+ированною
девальвированное|девальв+ированное
девальвированные|девальв+ированные
девальвированных|девальв+ированных
девальвированными|девальв+ированными
девальвировав|девальв+ировав
девальвировавши|девальв+ировавши
девальвирующий|девальв+ирующий
девальвирующего|девальв+ирующего
девальвирующему|девальв+ирующему
девальвирующим|девальв+ирующим
девальвирующем|девальв+ирующем
девальвирующая|девальв+ирующая
девальвирующей|девальв+ирующей
девальвирующую|девальв+ирующую
девальвирующею|девальв+ирующею
девальвирующее|девальв+ирующее
девальвирующие|девальв+ирующие
девальвирующих|девальв+ирующих
девальвирующими|девальв+ирующими
девальвируемый|девальв+ируемый
девальвируемого|девальв+ируемого
девальвируемому|девальв+ируемому
девальвируемым|девальв+ируемым
девальвируемом|девальв+ируемом
девальвируемая|девальв+ируемая
девальвируемой|девальв+ируемой
девальвируемую|девальв+ируемую
девальвируемою|девальв+ируемою
девальвируемое|девальв+ируемое
девальвируемые|девальв+ируемые
девальвируемых|девальв+ируемых
девальвируемыми|девальв+ируемыми
девальвируя|девальв+ируя
девальвируема|девальв+ируема
девальвируемо|девальв+ируемо
девальвируемы|девальв+ируемы
девальвирован|девальв+ирован
девальвирована|девальв+ирована
девальвировано|девальв+ировано
девальвированы|девальв+ированы
девальвировать|дэвальв+ировать
девальвироваться|дэвальв+ироваться
девальвируюсь|дэвальв+ируюсь
девальвируемся|дэвальв+ируемся
девальвируешься|дэвальв+ируешься
девальвируетесь|дэвальв+ируетесь
девальвируется|дэвальв+ируется
девальвируются|дэвальв+ируются
девальвировался|дэвальв+ировался
девальвировалась|дэвальв+ировалась
девальвировалось|дэвальв+ировалось
девальвировались|дэвальв+ировались
девальвируйся|дэвальв+ируйся
девальвируйтесь|дэвальв+ируйтесь
девальвирующийся|дэвальв+ирующийся
девальвирующегося|дэвальв+ирующегося
девальвирующемуся|дэвальв+ирующемуся
девальвирующимся|дэвальв+ирующимся
девальвирующемся|дэвальв+ирующемся
девальвирующаяся|дэвальв+ирующаяся
девальвирующейся|дэвальв+ирующейся
девальвирующуюся|дэвальв+ирующуюся
девальвирующеюся|дэвальв+ирующеюся
девальвирующееся|дэвальв+ирующееся
девальвирующиеся|дэвальв+ирующиеся
девальвирующихся|дэвальв+ирующихся
девальвирующимися|дэвальв+ирующимися
девальвировавшийся|дэвальв+ировавшийся
девальвировавшегося|дэвальв+ировавшегося
девальвировавшемуся|дэвальв+ировавшемуся
девальвировавшимся|дэвальв+ировавшимся
девальвировавшемся|дэвальв+ировавшемся
девальвировавшаяся|дэвальв+ировавшаяся
девальвировавшейся|дэвальв+ировавшейся
девальвировавшуюся|дэвальв+ировавшуюся
девальвировавшеюся|дэвальв+ировавшеюся
девальвировавшееся|дэвальв+ировавшееся
девальвировавшиеся|дэвальв+ировавшиеся
девальвировавшихся|дэвальв+ировавшихся
девальвировавшимися|дэвальв+ировавшимися
девальвируясь|дэвальв+ируясь
девальвировавшись|дэвальв+ировавшись
деградационный|дэградаци+онный
деградационного|дэградаци+онного
деградационному|дэградаци+онному
деградационным|дэградаци+онным
деградационном|дэградаци+онном
деградационная|дэградаци+онная
деградационной|дэградаци+онной
деградационную|дэградаци+онную
деградационною|дэградаци+онною
деградационное|дэградаци+онное
деградационные|дэградаци+онные
деградационных|дэградаци+онных
деградационными|дэградаци+онными
деградированный|дэград+ированный
деградированного|дэград+ированного
деградированному|дэград+ированному
деградированным|дэград+ированным
деградированном|дэград+ированном
деградированная|дэград+ированная
деградированной|дэград+ированной
деградированную|дэград+ированную
деградированною|дэград+ированною
деградированное|дэград+ированное
деградированные|дэград+ированные
деградированных|дэград+ированных
деградированными|дэград+ированными
деградировавший|дэград+ировавший
деградировал|дэград+ировал
деградировала|дэград+ировала
деградировало|дэград+ировало
деградировали|дэград+ировали
деградирую|дэград+ирую
деградируем|дэград+ируем
деградируешь|дэград+ируешь
деградируете|дэград+ируете
деградирует|дэград+ирует
деградируют|дэград+ируют
деградируй|дэград+ируй
деградируйте|дэград+ируйте
деградировавшего|дэград+ировавшего
деградировавшему|дэград+ировавшему
деградировавшим|дэград+ировавшим
деградировавшем|дэград+ировавшем
деградировавшая|дэград+ировавшая
деградировавшей|дэград+ировавшей
деградировавшую|дэград+ировавшую
деградировавшею|дэград+ировавшею
деградировавшее|дэград+ировавшее
деградировавшие|дэград+ировавшие
деградировавших|дэград+ировавших
деградировавшими|дэград+ировавшими
деградировав|дэград+ировав
деградировавши|дэград+ировавши
деградирующий|дэград+ирующий
деградирующего|дэград+ирующего
деградирующему|дэград+ирующему
деградирующим|дэград+ирующим
деградирующем|дэград+ирующем
деградирующая|дэград+ирующая
деградирующей|дэград+ирующей
деградирующую|дэград+ирующую
деградирующею|дэград+ирующею
деградирующее|дэград+ирующее
деградирующие|дэград+ирующие
деградирующих|дэград+ирующих
деградирующими|дэград+ирующими
деградируя|дэград+ируя
деградировать|дэград+ировать
дезавуирование|дэзаву+ирование
дезавуированье|дэзаву+ированье
дезавуирования|дэзаву+ирования
дезавуированья|дэзаву+ированья
дезавуированию|дэзаву+ированию
дезавуированью|дэзаву+ированью
дезавуированием|дэзаву+ированием
дезавуированьем|дэзаву+ированьем
дезавуировании|дэзаву+ировании
дезавуироваться|дэзаву+ироваться
дезавуируюсь|дэзаву+ируюсь
дезавуируемся|дэзаву+ируемся
дезавуируешься|дэзаву+ируешься
дезавуируетесь|дэзаву+ируетесь
дезавуируется|дэзаву+ируется
дезавуируются|дэзаву+ируются
дезавуировался|дэзаву+ировался
дезавуировалась|дэзаву+ировалась
дезавуировалось|дэзаву+ировалось
дезавуировались|дэзаву+ировались
дезавуируйся|дэзаву+ируйся
дезавуируйтесь|дэзаву+ируйтесь
дезавуирующийся|дэзаву+ирующийся
дезавуирующегося|дэзаву+ирующегося
дезавуирующемуся|дэзаву+ирующемуся
дезавуирующимся|дэзаву+ирующимся
дезавуирующемся|дэзаву+ирующемся
дезавуирующаяся|дэзаву+ирующаяся
дезавуирующейся|дэзаву+ирующейся
дезавуирующуюся|дэзаву+ирующуюся
дезавуирующеюся|дэзаву+ирующеюся
дезавуирующееся|дэзаву+ирующееся
дезавуирующиеся|дэзаву+ирующиеся
дезавуирующихся|дэзаву+ирующихся
дезавуирующимися|дэзаву+ирующимися
дезавуировавшийся|дэзаву+ировавшийся
дезавуировавшегося|дэзаву+ировавшегося
дезавуировавшемуся|дэзаву+ировавшемуся
дезавуировавшимся|дэзаву+ировавшимся
дезавуировавшемся|дэзаву+ировавшемся
дезавуировавшаяся|дэзаву+ировавшаяся
дезавуировавшейся|дэзаву+ировавшейся
дезавуировавшуюся|дэзаву+ировавшуюся
дезавуировавшеюся|дэзаву+ировавшеюся
дезавуировавшееся|дэзаву+ировавшееся
дезавуировавшиеся|дэзаву+ировавшиеся
дезавуировавшихся|дэзаву+ировавшихся
дезавуировавшимися|дэзаву+ировавшимися
дезавуируясь|дэзаву+ируясь
дезавуировавшись|дэзаву+ировавшись
деквалифицировать|дэквалифиц+ировать
деквалифицировал|дэквалифиц+ировал
деквалифицировала|дэквалифиц+ировала
деквалифицировало|дэквалифиц+ировало
деквалифицировали|дэквалифиц+ировали
деквалифицирую|дэквалифиц+ирую
деквалифицируем|дэквалифиц+ируем
деквалифицируешь|дэквалифиц+ируешь
деквалифицируете|дэквалифиц+ируете
деквалифицирует|дэквалифиц+ирует
деквалифицируют|дэквалифиц+ируют
деквалифицируемте|дэквалифиц+ируемте
деквалифицируй|дэквалифиц+ируй
деквалифицируйте|дэквалифиц+ируйте
деквалифицировавший|дэквалифиц+ировавший
деквалифицировавшего|дэквалифиц+ировавшего
деквалифицировавшему|дэквалифиц+ировавшему
деквалифицировавшим|дэквалифиц+ировавшим
деквалифицировавшем|дэквалифиц+ировавшем
деквалифицировавшая|дэквалифиц+ировавшая
деквалифицировавшей|дэквалифиц+ировавшей
деквалифицировавшую|дэквалифиц+ировавшую
деквалифицировавшею|дэквалифиц+ировавшею
деквалифицировавшее|дэквалифиц+ировавшее
деквалифицировавшие|дэквалифиц+ировавшие
деквалифицировавших|дэквалифиц+ировавших
деквалифицировавшими|дэквалифиц+ировавшими
деквалифицированный|дэквалифиц+ированный
деквалифицированного|дэквалифиц+ированного
деквалифицированному|дэквалифиц+ированному
деквалифицированным|дэквалифиц+ированным
деквалифицированном|дэквалифиц+ированном
деквалифицированная|дэквалифиц+ированная
деквалифицированной|дэквалифиц+ированной
деквалифицированную|дэквалифиц+ированную
деквалифицированною|дэквалифиц+ированною
деквалифицированное|дэквалифиц+ированное
деквалифицированные|дэквалифиц+ированные
деквалифицированных|дэквалифиц+ированных
деквалифицированными|дэквалифиц+ированными
деквалифицировав|дэквалифиц+ировав
деквалифицировавши|дэквалифиц+ировавши
деквалифицирующий|дэквалифиц+ирующий
деквалифицирующего|дэквалифиц+ирующего
деквалифицирующему|дэквалифиц+ирующему
деквалифицирующим|дэквалифиц+ирующим
деквалифицирующем|дэквалифиц+ирующем
деквалифицирующая|дэквалифиц+ирующая
деквалифицирующей|дэквалифиц+ирующей
деквалифицирующую|дэквалифиц+ирующую
деквалифицирующею|дэквалифиц+ирующею
деквалифицирующее|дэквалифиц+ирующее
деквалифицирующие|дэквалифиц+ирующие
деквалифицирующих|дэквалифиц+ирующих
деквалифицирующими|дэквалифиц+ирующими
деквалифицируемый|дэквалифиц+ируемый
деквалифицируемого|дэквалифиц+ируемого
деквалифицируемому|дэквалифиц+ируемому
деквалифицируемым|дэквалифиц+ируемым
деквалифицируемом|дэквалифиц+ируемом
деквалифицируемая|дэквалифиц+ируемая
деквалифицируемой|дэквалифиц+ируемой
деквалифицируемую|дэквалифиц+ируемую
деквалифицируемою|дэквалифиц+ируемою
деквалифицируемое|дэквалифиц+ируемое
деквалифицируемые|дэквалифиц+ируемые
деквалифицируемых|дэквалифиц+ируемых
деквалифицируемыми|дэквалифиц+ируемыми
деквалифицируя|дэквалифиц+ируя
деквалифицируема|дэквалифиц+ируема
деквалифицируемо|дэквалифиц+ируемо
деквалифицируемы|дэквалифиц+ируемы
деквалифицирован|дэквалифиц+ирован
деквалифицирована|дэквалифиц+ирована
деквалифицировано|дэквалифиц+ировано
деквалифицированы|дэквалифиц+ированы
декорации|дэкор+ации
декорацию|дэкор+ацию
декорацией|дэкор+ацией
декорациею|дэкор+ациею
декораций|дэкор+аций
декорациям|дэкор+ациям
декорациями|дэкор+ациями
декорациях|дэкор+ациях
декоративный|дэкорат+ивный
декоративного|дэкорат+ивного
декоративному|дэкорат+ивному
декоративным|дэкорат+ивным
декоративном|дэкорат+ивном
декоративная|дэкорат+ивная
декоративной|дэкорат+ивной
декоративную|дэкорат+ивную
декоративною|дэкорат+ивною
декоративное|дэкорат+ивное
декоративные|дэкорат+ивные
декоративных|дэкорат+ивных
декоративными|дэкорат+ивными
декоративен|дэкорат+ивен
декоративна|дэкорат+ивна
декоративно|дэкорат+ивно
декоративны|дэкорат+ивны
декоративнее|дэкорат+ивнее
декоративней|дэкорат+ивней
декорация|дэкор+ация
декорративно|дэкоррат+ивно
декорративный|дэкоррат+ивный
декорративного|дэкоррат+ивного
декорративному|дэкоррат+ивному
декорративным|дэкоррат+ивным
декорративном|дэкоррат+ивном
декорративная|дэкоррат+ивная
декорративной|дэкоррат+ивной
декорративную|дэкоррат+ивную
декорративною|дэкоррат+ивною
декорративное|дэкоррат+ивное
декорративные|дэкоррат+ивные
декорративных|дэкоррат+ивных
декорративными|дэкоррат+ивными
декорративен|дэкоррат+ивен
декорративна|дэкоррат+ивна
декорративны|дэкоррат+ивны
декоратор|дэкор+атор
декоратора|дэкор+атора
декоратору|дэкор+атору
декоратором|дэкор+атором
декораторе|дэкор+аторе
декораторы|дэкор+аторы
декораторов|дэкор+аторов
декораторам|дэкор+аторам
декораторами|дэкор+аторами
декораторах|дэкор+аторах
деликатесный|дэликат+есный
деликатесного|дэликат+есного
деликатесному|дэликат+есному
деликатесным|дэликат+есным
деликатесном|дэликат+есном
деликатесная|дэликат+есная
деликатесной|дэликат+есной
деликатесную|дэликат+есную
деликатесною|дэликат+есною
деликатесное|дэликат+есное
деликатесные|дэликат+есные
деликатесных|дэликат+есных
деликатесными|дэликат+есными
деликатесен|дэликат+есен
деликатесна|дэликат+есна
деликатесно|дэликат+есно
деликатесны|дэликат+есны
деликатеснее|дэликат+еснее
деликатесней|дэликат+есней
демотический|дэмот+ический
демотического|дэмот+ического
демотическому|дэмот+ическому
демотическим|дэмот+ическим
демотическом|дэмот+ическом
демотическая|дэмот+ическая
демотической|дэмот+ической
демотическую|дэмот+ическую
демотическою|дэмот+ическою
демотическое|дэмот+ическое
демотические|дэмот+ические
демотических|дэмот+ических
демотическими|дэмот+ическими
демпинговать|дэмпингов+ать
демпинговал|дэмпингов+ал
демпинговала|дэмпингов+ала
демпинговало|дэмпингов+ало
демпинговали|дэмпингов+али
демпинговавший|дэмпингов+авший
демпинговавшего|дэмпингов+авшего
демпинговавшему|дэмпингов+авшему
демпинговавшим|дэмпингов+авшим
демпинговавшем|дэмпингов+авшем
демпинговавшая|дэмпингов+авшая
демпинговавшей|дэмпингов+авшей
демпинговавшую|дэмпингов+авшую
демпинговавшею|дэмпингов+авшею
демпинговавшее|дэмпингов+авшее
демпинговавшие|дэмпингов+авшие
демпинговавших|дэмпингов+авших
демпинговавшими|дэмпингов+авшими
демпингованный|дэмпингов+анный
демпингованного|дэмпингов+анного
демпингованному|дэмпингов+анному
демпингованным|дэмпингов+анным
демпингованном|дэмпингов+анном
демпингованная|дэмпингов+анная
демпингованной|дэмпингов+анной
демпингованную|дэмпингов+анную
демпингованною|дэмпингов+анною
демпингованное|дэмпингов+анное
демпингованные|дэмпингов+анные
демпингованных|дэмпингов+анных
демпингованными|дэмпингов+анными
демпинговав|дэмпингов+ав
демпинговавши|дэмпингов+авши
демпингован|дэмпингов+ан
демпингована|дэмпингов+ана
демпинговано|дэмпингов+ано
демпингованы|дэмпингов+аны
демпинговати|дэмпингов+ати
демпинговатью|дэмпингов+атью
демпинговатей|дэмпингов+атей
демпинговатям|дэмпингов+атям
демпинговатями|дэмпингов+атями
демпинговатях|дэмпингов+атях
демпинговый|д+эмпинговый
деноминационализм|дэноминационал+изм
деноминационализма|дэноминационал+изма
деноминационализму|дэноминационал+изму
деноминационализмом|дэноминационал+измом
деноминационализме|дэноминационал+изме
деноминационализмы|дэноминационал+измы
деноминационализмов|дэноминационал+измов
деноминационализмам|дэноминационал+измам
деноминационализмами|дэноминационал+измами
деноминационализмах|дэноминационал+измах
денонсировать|дэнонс+ировать
денонсировал|дэнонс+ировал
денонсировала|дэнонс+ировала
денонсировало|дэнонс+ировало
денонсировали|дэнонс+ировали
денонсирую|дэнонс+ирую
денонсируем|дэнонс+ируем
денонсируешь|дэнонс+ируешь
денонсируете|дэнонс+ируете
денонсирует|дэнонс+ирует
денонсируют|дэнонс+ируют
денонсируемте|дэнонс+ируемте
денонсируй|дэнонс+ируй
денонсируйте|дэнонс+ируйте
денонсировавший|дэнонс+ировавший
денонсировавшего|дэнонс+ировавшего
денонсировавшему|дэнонс+ировавшему
денонсировавшим|дэнонс+ировавшим
денонсировавшем|дэнонс+ировавшем
денонсировавшая|дэнонс+ировавшая
денонсировавшей|дэнонс+ировавшей
денонсировавшую|дэнонс+ировавшую
денонсировавшею|дэнонс+ировавшею
денонсировавшее|дэнонс+ировавшее
денонсировавшие|дэнонс+ировавшие
денонсировавших|дэнонс+ировавших
денонсировавшими|дэнонс+ировавшими
денонсированный|дэнонс+ированный
денонсированного|дэнонс+ированного
денонсированному|дэнонс+ированному
денонсированным|дэнонс+ированным
денонсированном|дэнонс+ированном
денонсированная|дэнонс+ированная
денонсированной|дэнонс+ированной
денонсированную|дэнонс+ированную
денонсированною|дэнонс+ированною
денонсированное|дэнонс+ированное
денонсированные|дэнонс+ированные
денонсированных|дэнонс+ированных
денонсированными|дэнонс+ированными
денонсировав|дэнонс+ировав
денонсировавши|дэнонс+ировавши
денонсирующий|дэнонс+ирующий
денонсирующего|дэнонс+ирующего
денонсирующему|дэнонс+ирующему
денонсирующим|дэнонс+ирующим
денонсирующем|дэнонс+ирующем
денонсирующая|дэнонс+ирующая
денонсирующей|дэнонс+ирующей
денонсирующую|дэнонс+ирующую
денонсирующею|дэнонс+ирующею
денонсирующее|дэнонс+ирующее
денонсирующие|дэнонс+ирующие
денонсирующих|дэнонс+ирующих
денонсирующими|дэнонс+ирующими
денонсируемый|дэнонс+ируемый
денонсируемого|дэнонс+ируемого
денонсируемому|дэнонс+ируемому
денонсируемым|дэнонс+ируемым
денонсируемом|дэнонс+ируемом
денонсируемая|дэнонс+ируемая
денонсируемой|дэнонс+ируемой
денонсируемую|дэнонс+ируемую
денонсируемою|дэнонс+ируемою
денонсируемое|дэнонс+ируемое
денонсируемые|дэнонс+ируемые
денонсируемых|дэнонс+ируемых
денонсируемыми|дэнонс+ируемыми
денонсируя|дэнонс+ируя
денонсируема|дэнонс+ируема
денонсируемо|дэнонс+ируемо
денонсируемы|дэнонс+ируемы
денонсирован|дэнонс+ирован
денонсирована|дэнонс+ирована
денонсировано|дэнонс+ировано
денонсированы|дэнонс+ированы
денонсирование|дэнонс+ирование
денонсированье|дэнонс+ированье
денонсирования|дэнонс+ирования
денонсированья|дэнонс+ированья
денонсированию|дэнонс+ированию
денонсированью|дэнонс+ированью
денонсированием|дэнонс+ированием
денонсированьем|дэнонс+ированьем
денонсировании|дэнонс+ировании
денонсированьи|дэнонс+ированьи
денонсирований|дэнонс+ирований
денонсированиям|дэнонс+ированиям
денонсированьям|дэнонс+ированьям
денонсированиями|дэнонс+ированиями
денонсированьями|дэнонс+ированьями
денонсированиях|дэнонс+ированиях
денонсированьях|дэнонс+ированьях
денонсироваться|дэнонс+ироваться
денонсируюсь|дэнонс+ируюсь
денонсируемся|дэнонс+ируемся
денонсируешься|дэнонс+ируешься
денонсируетесь|дэнонс+ируетесь
денонсируется|дэнонс+ируется
денонсируются|дэнонс+ируются
денонсировался|дэнонс+ировался
денонсировалась|дэнонс+ировалась
денонсировалось|дэнонс+ировалось
денонсировались|дэнонс+ировались
денонсируйся|дэнонс+ируйся
денонсируйтесь|дэнонс+ируйтесь
денонсирующийся|дэнонс+ирующийся
денонсирующегося|дэнонс+ирующегося
денонсирующемуся|дэнонс+ирующемуся
денонсирующимся|дэнонс+ирующимся
денонсирующемся|дэнонс+ирующемся
денонсирующаяся|дэнонс+ирующаяся
денонсирующейся|дэнонс+ирующейся
денонсирующуюся|дэнонс+ирующуюся
денонсирующеюся|дэнонс+ирующеюся
денонсирующееся|дэнонс+ирующееся
денонсирующиеся|дэнонс+ирующиеся
денонсирующихся|дэнонс+ирующихся
денонсирующимися|дэнонс+ирующимися
денонсировавшийся|дэнонс+ировавшийся
денонсировавшегося|дэнонс+ировавшегося
денонсировавшемуся|дэнонс+ировавшемуся
денонсировавшимся|дэнонс+ировавшимся
денонсировавшемся|дэнонс+ировавшемся
денонсировавшаяся|дэнонс+ировавшаяся
денонсировавшейся|дэнонс+ировавшейся
денонсировавшуюся|дэнонс+ировавшуюся
денонсировавшеюся|дэнонс+ировавшеюся
денонсировавшееся|дэнонс+ировавшееся
денонсировавшиеся|дэнонс+ировавшиеся
денонсировавшихся|дэнонс+ировавшихся
денонсировавшимися|дэнонс+ировавшимися
денонсируясь|дэнонс+ируясь
денонсировавшись|дэнонс+ировавшись
дермальный|дэрм+альный
дермального|дэрм+ального
дермальному|дэрм+альному
дермальным|дэрм+альным
дермальном|дэрм+альном
дермальная|дэрм+альная
дермальной|дэрм+альной
дермальную|дэрм+альную
дермальною|дэрм+альною
дермальное|дэрм+альное
дермальные|дэрм+альные
дермальных|дэрм+альных
дермальными|дэрм+альными
дерматин|дэрмат+ин
дерматина|дэрмат+ина
дерматину|дэрмат+ину
дерматином|дэрмат+ином
дерматине|дэрмат+ине
дерматины|дэрмат+ины
дерматинов|дэрмат+инов
дерматинам|дэрмат+инам
дерматинами|дэрмат+инами
дерматинах|дэрмат+инах
дерматиновый|дэрмат+иновый
дерматинового|дэрмат+инового
дерматиновому|дэрмат+иновому
дерматиновым|дэрмат+иновым
дерматиновом|дэрмат+иновом
дерматиновая|дэрмат+иновая
дерматиновой|дэрмат+иновой
дерматиновую|дэрмат+иновую
дерматиновою|дэрмат+иновою
дерматиновое|дэрмат+иновое
дерматиновые|дэрмат+иновые
дерматиновых|дэрмат+иновых
дерматиновыми|дэрмат+иновыми
дерматинова|дэрмат+инова
дерматиново|дэрмат+иново
дерматиновы|дэрмат+иновы
дерматиновее|дэрмат+иновее
дерматиновей|дэрмат+иновей
дерматит|дэрмат+ит
дерматита|дэрмат+ита
дерматиту|дэрмат+иту
дерматитом|дэрмат+итом
дерматите|дэрмат+ите
дерматиты|дэрмат+иты
дерматитов|дэрмат+итов
дерматитам|дэрмат+итам
дерматитами|дэрмат+итами
дерматитах|дэрмат+итах
дерматолог|дэрмат+олог
дерматолога|дэрмат+олога
дерматологу|дэрмат+ологу
дерматологом|дэрмат+ологом
дерматологе|дэрмат+ологе
дерматологи|дэрмат+ологи
дерматологов|дэрмат+ологов
дерматологам|дэрмат+ологам
дерматологами|дэрмат+ологами
дерматологах|дэрмат+ологах
дерматологический|дэрматолог+ический
дерматологического|дэрматолог+ического
дерматологическому|дэрматолог+ическому
дерматологическим|дэрматолог+ическим
дерматологическом|дэрматолог+ическом
дерматологическая|дэрматолог+ическая
дерматологической|дэрматолог+ической
дерматологическую|дэрматолог+ическую
дерматологическою|дэрматолог+ическою
дерматологическое|дэрматолог+ическое
дерматологические|дэрматолог+ические
дерматологических|дэрматолог+ических
дерматологическими|дэрматолог+ическими
десегрегировать|дэсегрег+ировать
десегрегировал|дэсегрег+ировал
десегрегировала|дэсегрег+ировала
десегрегировало|дэсегрег+ировало
десегрегировали|дэсегрег+ировали
десегрегирую|дэсегрег+ирую
десегрегируем|дэсегрег+ируем
десегрегируешь|дэсегрег+ируешь
десегрегируете|дэсегрег+ируете
десегрегирует|дэсегрег+ирует
десегрегируют|дэсегрег+ируют
десегрегируемте|дэсегрег+ируемте
десегрегируй|дэсегрег+ируй
десегрегируйте|дэсегрег+ируйте
десегрегировавший|дэсегрег+ировавший
десегрегировавшего|дэсегрег+ировавшего
десегрегировавшему|дэсегрег+ировавшему
десегрегировавшим|дэсегрег+ировавшим
десегрегировавшем|дэсегрег+ировавшем
десегрегировавшая|дэсегрег+ировавшая
десегрегировавшей|дэсегрег+ировавшей
десегрегировавшую|дэсегрег+ировавшую
десегрегировавшею|дэсегрег+ировавшею
десегрегировавшее|дэсегрег+ировавшее
десегрегировавшие|дэсегрег+ировавшие
десегрегировавших|дэсегрег+ировавших
десегрегировавшими|дэсегрег+ировавшими
десегрегированный|дэсегрег+ированный
десегрегированного|дэсегрег+ированного
десегрегированному|дэсегрег+ированному
десегрегированным|дэсегрег+ированным
десегрегированном|дэсегрег+ированном
десегрегированная|дэсегрег+ированная
десегрегированной|дэсегрег+ированной
десегрегированную|дэсегрег+ированную
десегрегированною|дэсегрег+ированною
десегрегированное|дэсегрег+ированное
десегрегированные|дэсегрег+ированные
десегрегированных|дэсегрег+ированных
десегрегированными|дэсегрег+ированными
десегрегировав|дэсегрег+ировав
десегрегировавши|дэсегрег+ировавши
десегрегирующий|дэсегрег+ирующий
десегрегирующего|дэсегрег+ирующего
десегрегирующему|дэсегрег+ирующему
десегрегирующим|дэсегрег+ирующим
десегрегирующем|дэсегрег+ирующем
десегрегирующая|дэсегрег+ирующая
десегрегирующей|дэсегрег+ирующей
десегрегирующую|дэсегрег+ирующую
десегрегирующею|дэсегрег+ирующею
десегрегирующее|дэсегрег+ирующее
десегрегирующие|дэсегрег+ирующие
десегрегирующих|дэсегрег+ирующих
десегрегирующими|дэсегрег+ирующими
десегрегируемый|дэсегрег+ируемый
десегрегируемого|дэсегрег+ируемого
десегрегируемому|дэсегрег+ируемому
десегрегируемым|дэсегрег+ируемым
десегрегируемом|дэсегрег+ируемом
десегрегируемая|дэсегрег+ируемая
десегрегируемой|дэсегрег+ируемой
десегрегируемую|дэсегрег+ируемую
десегрегируемою|дэсегрег+ируемою
десегрегируемое|дэсегрег+ируемое
десегрегируемые|дэсегрег+ируемые
десегрегируемых|дэсегрег+ируемых
десегрегируемыми|дэсегрег+ируемыми
десегрегируя|дэсегрег+ируя
десегрегируема|дэсегрег+ируема
десегрегируемо|дэсегрег+ируемо
десегрегируемы|дэсегрег+ируемы
десегрегирован|дэсегрег+ирован
десегрегирована|дэсегрег+ирована
десегрегировано|дэсегрег+ировано
десегрегированы|дэсегрег+ированы
десегрегировати|дэсегрег+ировати
десегрегироватью|дэсегрег+ироватью
десегрегироватей|дэсегрег+ироватей
десегрегироватям|дэсегрег+ироватям
десегрегироватями|дэсегрег+ироватями
десегрегироватях|дэсегрег+ироватях
детекторный|дэт+экторный
детекторного|дэт+экторного
детекторному|дэт+экторному
детекторным|дэт+экторным
детекторном|дэт+экторном
детекторная|дэт+экторная
детекторной|дэт+экторной
детекторную|дэт+экторную
детекторною|дэт+экторною
детекторное|дэт+экторное
детекторные|дэт+экторные
детекторных|дэт+экторных
детекторными|дэт+экторными
детекторен|дэт+экторен
детекторна|дэт+экторна
детекторно|дэт+экторно
детекторны|дэт+экторны
детекторнее|дэт+экторнее
детекторней|дэт+экторней
детерминант|дэтэрмин+ант
детерминанта|дэтэрмин+анта
детерминанту|дэтэрмин+анту
детерминантом|дэтэрмин+антом
детерминанте|дэтэрмин+анте
детерминанты|дэтэрмин+анты
детерминантов|дэтэрмин+антов
детерминантам|дэтэрмин+антам
детерминантами|дэтэрмин+антами
детерминантах|дэтэрмин+антах
детерминантный|дэтэрмин+антный
детерминантного|дэтэрмин+антного
детерминантному|дэтэрмин+антному
детерминантным|дэтэрмин+антным
детерминантном|дэтэрмин+антном
детерминантная|дэтэрмин+антная
детерминантной|дэтэрмин+антной
детерминантную|дэтэрмин+антную
детерминантною|дэтэрмин+антною
детерминантное|дэтэрмин+антное
детерминантные|дэтэрмин+антные
детерминантных|дэтэрмин+антных
детерминантными|дэтэрмин+антными
детерминантен|дэтэрмин+антен
детерминантна|дэтэрмин+антна
детерминантно|дэтэрмин+антно
детерминантны|дэтэрмин+антны
детерминация|дэтэрмин+ация
детерминации|дэтэрмин+ации
детерминацию|дэтэрмин+ацию
детерминацией|дэтэрмин+ацией
детерминациею|дэтэрмин+ациею
детерминаций|дэтэрмин+аций
детерминациям|дэтэрмин+ациям
детерминациями|дэтэрмин+ациями
детерминациях|дэтэрмин+ациях
детерминированный|дэтэрмин+ированный
детерминированного|дэтэрмин+ированного
детерминированному|дэтэрмин+ированному
детерминированным|дэтэрмин+ированным
детерминированном|дэтэрмин+ированном
детерминированная|дэтэрмин+ированная
детерминированной|дэтэрмин+ированной
детерминированную|дэтэрмин+ированную
детерминированною|дэтэрмин+ированною
детерминированное|дэтэрмин+ированное
детерминированные|дэтэрмин+ированные
детерминированных|дэтэрмин+ированных
детерминированными|дэтэрмин+ированными
детерминировал|дэтэрмин+ировал
детерминировала|дэтэрмин+ировала
детерминировало|дэтэрмин+ировало
детерминировали|дэтэрмин+ировали
детерминирую|дэтэрмин+ирую
детерминируем|дэтэрмин+ируем
детерминируешь|дэтэрмин+ируешь
детерминируете|дэтэрмин+ируете
детерминирует|дэтэрмин+ирует
детерминируют|дэтэрмин+ируют
детерминируемте|дэтэрмин+ируемте
детерминируй|дэтэрмин+ируй
детерминируйте|дэтэрмин+ируйте
детерминировавший|дэтэрмин+ировавший
детерминировавшего|дэтэрмин+ировавшего
детерминировавшему|дэтэрмин+ировавшему
детерминировавшим|дэтэрмин+ировавшим
детерминировавшем|дэтэрмин+ировавшем
детерминировавшая|дэтэрмин+ировавшая
детерминировавшей|дэтэрмин+ировавшей
детерминировавшую|дэтэрмин+ировавшую
детерминировавшею|дэтэрмин+ировавшею
детерминировавшее|дэтэрмин+ировавшее
детерминировавшие|дэтэрмин+ировавшие
детерминировавших|дэтэрмин+ировавших
детерминировавшими|дэтэрмин+ировавшими
детерминировав|дэтэрмин+ировав
детерминировавши|дэтэрмин+ировавши
детерминирующий|дэтэрмин+ирующий
детерминирующего|дэтэрмин+ирующего
детерминирующему|дэтэрмин+ирующему
детерминирующим|дэтэрмин+ирующим
детерминирующем|дэтэрмин+ирующем
детерминирующая|дэтэрмин+ирующая
детерминирующей|дэтэрмин+ирующей
детерминирующую|дэтэрмин+ирующую
детерминирующею|дэтэрмин+ирующею
детерминирующее|дэтэрмин+ирующее
детерминирующие|дэтэрмин+ирующие
детерминирующих|дэтэрмин+ирующих
детерминирующими|дэтэрмин+ирующими
детерминируемый|дэтэрмин+ируемый
детерминируемого|дэтэрмин+ируемого
детерминируемому|дэтэрмин+ируемому
детерминируемым|дэтэрмин+ируемым
детерминируемом|дэтэрмин+ируемом
детерминируемая|дэтэрмин+ируемая
детерминируемой|дэтэрмин+ируемой
детерминируемую|дэтэрмин+ируемую
детерминируемою|дэтэрмин+ируемою
детерминируемое|дэтэрмин+ируемое
детерминируемые|дэтэрмин+ируемые
детерминируемых|дэтэрмин+ируемых
детерминируемыми|дэтэрмин+ируемыми
детерминируя|дэтэрмин+ируя
детерминируема|дэтэрмин+ируема
детерминируемо|дэтэрмин+ируемо
детерминируемы|дэтэрмин+ируемы
детерминирован|дэтэрмин+ирован
детерминирована|дэтэрмин+ирована
детерминировано|дэтэрмин+ировано
детерминированы|дэтэрмин+ированы
детерминировать|дэтэрмин+ировать
детерминист|дэтэрмин+ист
детерминиста|дэтэрмин+иста
детерминисту|дэтэрмин+исту
детерминистом|дэтэрмин+истом
детерминисте|дэтэрмин+исте
детерминисты|дэтэрмин+исты
детерминистов|дэтэрмин+истов
детерминистам|дэтэрмин+истам
детерминистами|дэтэрмин+истами
детерминистах|дэтэрмин+истах
дефлекторный|дэфл+екторный
дефлекторного|дэфл+екторного
дефлекторному|дэфл+екторному
дефлекторным|дэфл+екторным
дефлекторном|дэфл+екторном
дефлекторная|дэфл+екторная
дефлекторной|дэфл+екторной
дефлекторную|дэфл+екторную
дефлекторною|дэфл+екторною
дефлекторное|дэфл+екторное
дефлекторные|дэфл+екторные
дефлекторных|дэфл+екторных
дефлекторными|дэфл+екторными
дефлекторен|дэфл+екторен
дефлекторна|дэфл+екторна
дефлекторно|дэфл+екторно
дефлекторны|дэфл+екторны
дефлекторнее|дэфл+екторнее
дефлекторней|дэфл+екторней
дефлекпоторнее|дэфл+екпоторнее
дефлекпоторней|дэфл+екпоторней
дефляционный|дэфляци+онный
дефляционного|дэфляци+онного
дефляционному|дэфляци+онному
дефляционным|дэфляци+онным
дефляционном|дэфляци+онном
дефляционная|дэфляци+онная
дефляционной|дэфляци+онной
дефляционную|дэфляци+онную
дефляционною|дэфляци+онною
дефляционное|дэфляци+онное
дефляционные|дэфляци+онные
дефляционных|дэфляци+онных
дефляционными|дэфляци+онными
дециметровый|дэцим+етровый
индекс|+индэкс
индекса|+индэкса
индексу|+индэксу
индексом|+индэксом
индексе|+индэксе
индексы|+индэксы
индексов|+индэксов
индексам|+индэксам
индексами|+индэксами
индексах|+индэксах
индексатор|индэкс+атор
индексатора|индэкс+атора
индексатору|индэкс+атору
индексатором|индэкс+атором
индексаторе|индэкс+аторе
индексаторы|индэкс+аторы
индексаторов|индэкс+аторов
индексаторам|индэкс+аторам
индексаторами|индэкс+аторами
индексаторах|индэкс+аторах
индексационный|индэксаци+онный
индексационного|индэксаци+онного
индексационному|индэксаци+онному
индексационным|индэксаци+онным
индексационном|индэксаци+онном
индексационная|индэксаци+онная
индексационной|индэксаци+онной
индексационную|индэксаци+онную
индексационною|индэксаци+онною
индексационное|индэксаци+онное
индексационные|индэксаци+онные
индексационных|индэксаци+онных
индексационными|индэксаци+онными
индексирование|индэкс+ирование
индексирования|индэкс+ирования
индексированию|индэкс+ированию
индексированием|индэкс+ированием
индексировании|индэкс+ировании
индексировать|индэкс+ировать
индексировал|индэкс+ировал
индексировала|индэкс+ировала
индексировало|индэкс+ировало
индексировали|индэкс+ировали
индексирую|индэкс+ирую
индексируем|индэкс+ируем
индексируешь|индэкс+ируешь
индексируете|индэкс+ируете
индексирует|индэкс+ирует
индексируют|индэкс+ируют
индексируемте|индэкс+ируемте
индексируй|индэкс+ируй
индексируйте|индэкс+ируйте
индексировавший|индэкс+ировавший
индексировавшего|индэкс+ировавшего
индексировавшему|индэкс+ировавшему
индексировавшим|индэкс+ировавшим
индексировавшем|индэкс+ировавшем
индексировавшая|индэкс+ировавшая
индексировавшей|индэкс+ировавшей
индексировавшую|индэкс+ировавшую
индексировавшею|индэкс+ировавшею
индексировавшее|индэкс+ировавшее
индексировавшие|индэкс+ировавшие
индексировавших|индэкс+ировавших
индексировавшими|индэкс+ировавшими
индексированный|индэкс+ированный
индексированного|индэкс+ированного
индексированному|индэкс+ированному
индексированным|индэкс+ированным
индексированном|индэкс+ированном
индексированная|индэкс+ированная
индексированной|индэкс+ированной
индексированную|индэкс+ированную
индексированною|индэкс+ированною
индексированное|индэкс+ированное
индексированные|индэкс+ированные
индексированных|индэкс+ированных
индексированными|индэкс+ированными
индексировав|индэкс+ировав
индексировавши|индэкс+ировавши
индексирующий|индэкс+ирующий
индексирующего|индэкс+ирующего
индексирующему|индэкс+ирующему
индексирующим|индэкс+ирующим
индексирующем|индэкс+ирующем
индексирующая|индэкс+ирующая
индексирующей|индэкс+ирующей
индексирующую|индэкс+ирующую
индексирующею|индэкс+ирующею
индексирующее|индэкс+ирующее
индексирующие|индэкс+ирующие
индексирующих|индэкс+ирующих
индексирующими|индэкс+ирующими
индексируемый|индэкс+ируемый
индексируемого|индэкс+ируемого
индексируемому|индэкс+ируемому
индексируемым|индэкс+ируемым
индексируемом|индэкс+ируемом
индексируемая|индэкс+ируемая
индексируемой|индэкс+ируемой
индексируемую|индэкс+ируемую
индексируемою|индэкс+ируемою
индексируемое|индэкс+ируемое
индексируемые|индэкс+ируемые
индексируемых|индэкс+ируемых
индексируемыми|индэкс+ируемыми
индексируя|индэкс+ируя
индексируема|индэкс+ируема
индексируемо|индэкс+ируемо
индексируемы|индэкс+ируемы
индексирован|индэкс+ирован
индексирована|индэкс+ирована
индексировано|индэкс+ировано
индексированы|индэкс+ированы
индексный|+индэксный
индексного|+индэксного
индексному|+индэксному
индексным|+индэксным
индексном|+индэксном
индексная|+индэксная
индексной|+индэксной
индексную|+индэксную
индексною|+индэксною
индексное|+индэксное
индексные|+индэксные
индексных|+индэксных
индексными|+индэксными
индексен|+индэксен
индексна|+индэксна
индексно|+индэксно
индексны|+индэксны
индекснее|+индэкснее
индексней|+индэксней
компьютеризация|компьютэриз+ация
компьютеризации|компьютэриз+ации
компьютеризацию|компьютэриз+ацию
компьютеризацией|компьютэриз+ацией
компьютеризациею|компьютэриз+ациею
компьютеризаций|компьютэриз+аций
компьютеризациям|компьютэриз+ациям
компьютеризациями|компьютэриз+ациями
компьютеризациях|компьютэриз+ациях
компьютеризировать|компьютэриз+ировать
компьютеризировал|компьютэриз+ировал
компьютеризировала|компьютэриз+ировала
компьютеризировало|компьютэриз+ировало
компьютеризировали|компьютэриз+ировали
компьютеризирую|компьютэриз+ирую
компьютеризируем|компьютэриз+ируем
компьютеризируешь|компьютэриз+ируешь
компьютеризируете|компьютэриз+ируете
компьютеризирует|компьютэриз+ирует
компьютеризируют|компьютэриз+ируют
компьютеризируемте|компьютэриз+ируемте
компьютеризируй|компьютэриз+ируй
компьютеризируйте|компьютэриз+ируйте
компьютеризировавший|компьютэриз+ировавший
компьютеризировавшего|компьютэриз+ировавшего
компьютеризировавшему|компьютэриз+ировавшему
компьютеризировавшим|компьютэриз+ировавшим
компьютеризировавшем|компьютэриз+ировавшем
компьютеризировавшая|компьютэриз+ировавшая
компьютеризировавшей|компьютэриз+ировавшей
компьютеризировавшую|компьютэриз+ировавшую
компьютеризировавшею|компьютэриз+ировавшею
компьютеризировавшее|компьютэриз+ировавшее
компьютеризировавшие|компьютэриз+ировавшие
компьютеризировавших|компьютэриз+ировавших
компьютеризировавшими|компьютэриз+ировавшими
компьютеризированный|компьютэриз+ированный
компьютеризированного|компьютэриз+ированного
компьютеризированному|компьютэриз+ированному
компьютеризированным|компьютэриз+ированным
компьютеризированном|компьютэриз+ированном
компьютеризированная|компьютэриз+ированная
компьютеризированной|компьютэриз+ированной
компьютеризированную|компьютэриз+ированную
компьютеризированною|компьютэриз+ированною
компьютеризированное|компьютэриз+ированное
компьютеризированные|компьютэриз+ированные
компьютеризированных|компьютэриз+ированных
компьютеризированными|компьютэриз+ированными
компьютеризировав|компьютэриз+ировав
компьютеризировавши|компьютэриз+ировавши
компьютеризирующий|компьютэриз+ирующий
компьютеризирующего|компьютэриз+ирующего
компьютеризирующему|компьютэриз+ирующему
компьютеризирующим|компьютэриз+ирующим
компьютеризирующем|компьютэриз+ирующем
компьютеризирующая|компьютэриз+ирующая
компьютеризирующей|компьютэриз+ирующей
компьютеризирующую|компьютэриз+ирующую
компьютеризирующею|компьютэриз+ирующею
компьютеризирующее|компьютэриз+ирующее
компьютеризирующие|компьютэриз+ирующие
компьютеризирующих|компьютэриз+ирующих
компьютеризирующими|компьютэриз+ирующими
компьютеризируемый|компьютэриз+ируемый
компьютеризируемого|компьютэриз+ируемого
компьютеризируемому|компьютэриз+ируемому
компьютеризируемым|компьютэриз+ируемым
компьютеризируемом|компьютэриз+ируемом
компьютеризируемая|компьютэриз+ируемая
компьютеризируемой|компьютэриз+ируемой
компьютеризируемую|компьютэриз+ируемую
компьютеризируемою|компьютэриз+ируемою
компьютеризируемое|компьютэриз+ируемое
компьютеризируемые|компьютэриз+ируемые
компьютеризируемых|компьютэриз+ируемых
компьютеризируемыми|компьютэриз+ируемыми
компьютеризируя|компьютэриз+ируя
компьютеризируема|компьютэриз+ируема
компьютеризируемо|компьютэриз+ируемо
компьютеризируемы|компьютэриз+ируемы
компьютеризирован|компьютэриз+ирован
компьютеризирована|компьютэриз+ирована
компьютеризировано|компьютэриз+ировано
компьютеризированы|компьютэриз+ированы
компьютеризовать|компьютэризов+ать
компьютеризовал|компьютэризов+ал
компьютеризовала|компьютэризов+ала
компьютеризовало|компьютэризов+ало
компьютеризовали|компьютэризов+али
компьютеризовавший|компьютэризов+авший
компьютеризовавшего|компьютэризов+авшего
компьютеризовавшему|компьютэризов+авшему
компьютеризовавшим|компьютэризов+авшим
компьютеризовавшем|компьютэризов+авшем
компьютеризовавшая|компьютэризов+авшая
компьютеризовавшей|компьютэризов+авшей
компьютеризовавшую|компьютэризов+авшую
компьютеризовавшею|компьютэризов+авшею
компьютеризовавшее|компьютэризов+авшее
компьютеризовавшие|компьютэризов+авшие
компьютеризовавших|компьютэризов+авших
компьютеризовавшими|компьютэризов+авшими
компьютеризованный|компьютэризов+анный
компьютеризованного|компьютэризов+анного
компьютеризованному|компьютэризов+анному
компьютеризованным|компьютэризов+анным
компьютеризованном|компьютэризов+анном
компьютеризованная|компьютэризов+анная
компьютеризованной|компьютэризов+анной
компьютеризованную|компьютэризов+анную
компьютеризованною|компьютэризов+анною
компьютеризованное|компьютэризов+анное
компьютеризованные|компьютэризов+анные
компьютеризованных|компьютэризов+анных
компьютеризованными|компьютэризов+анными
компьютеризовав|компьютэризов+ав
компьютеризовавши|компьютэризов+авши
компьютеризован|компьютэризов+ан
компьютеризована|компьютэризов+ана
компьютеризовано|компьютэризов+ано
компьютеризованы|компьютэризов+аны
компьютерность|компь+ютэрность
компьютерности|компь+ютэрности
компьютерностью|компь+ютэрностью
компьютерностей|компь+ютэрностей
компьютерностям|компь+ютэрностям
компьютерностями|компь+ютэрностями
компьютерностях|компь+ютэрностях
компьютерный|компь+ютэрный
компьютерного|компь+ютэрного
компьютерному|компь+ютэрному
компьютерным|компь+ютэрным
компьютерном|компь+ютэрном
компьютерная|компь+ютэрная
компьютерной|компь+ютэрной
компьютерную|компь+ютэрную
компьютерною|компь+ютэрною
компьютерное|компь+ютэрное
компьютерные|компь+ютэрные
компьютерных|компь+ютэрных
компьютерными|компь+ютэрными
компьютерщик|компь+ютэрщик
компьютерщика|компь+ютэрщика
компьютерщику|компь+ютэрщику
компьютерщиком|компь+ютэрщиком
компьютерщике|компь+ютэрщике
компьютерщики|компь+ютэрщики
компьютерщиков|компь+ютэрщиков
компьютерщикам|компь+ютэрщикам
компьютерщиками|компь+ютэрщиками
компьютерщиках|компь+ютэрщиках
суперкомпьютер|суперкомпь+ютэр
суперкомпьютера|суперкомпь+ютэра
суперкомпьютеру|суперкомпь+ютэру
суперкомпьютером|суперкомпь+ютэром
суперкомпьютере|суперкомпь+ютэре
суперкомпьютеры|суперкомпь+ютэры
суперкомпьютеров|суперкомпь+ютэров
суперкомпьютерам|суперкомпь+ютэрам
суперкомпьютерами|суперкомпь+ютэрами
суперкомпьютерах|суперкомпь+ютэрах
консенсусно|конс+энсусно
консенсусный|конс+энсусный
консенсусного|конс+энсусного
консенсусному|конс+энсусному
консенсусным|конс+энсусным
консенсусном|конс+энсусном
консенсусная|конс+энсусная
консенсусной|конс+энсусной
консенсусную|конс+энсусную
консенсусною|конс+энсусною
консенсусное|конс+энсусное
консенсусные|конс+энсусные
консенсусных|конс+энсусных
консенсусными|конс+энсусными
консенсусен|конс+энсусен
консенсусна|конс+энсусна
консенсусны|конс+энсусны
консенсуснее|конс+энсуснее
консенсусней|конс+энсусней
консенсусность|конс+энсусность
консенсусности|конс+энсусности
консенсусностью|конс+энсусностью
консенсусностей|конс+энсусностей
консенсусностям|конс+энсусностям
консенсусностями|конс+энсусностями
консенсусностях|конс+энсусностях
конфидент|конфид+энт
конфидента|конфид+энта
конфиденту|конфид+энту
конфидентом|конфид+энтом
конфиденте|конфид+энте
конфиденты|конфид+энты
конфидентов|конфид+энтов
конфидентам|конфид+энтам
конфидентами|конфид+энтами
конфидентах|конфид+энтах
конфидентка|конфид+энтка
конфидентки|конфид+энтки
конфидентке|конфид+энтке
конфидентку|конфид+энтку
конфиденткой|конфид+энткой
конфиденткою|конфид+энткою
конфиденток|конфид+энток
конфиденткам|конфид+энткам
конфидентками|конфид+энтками
конфидентках|конфид+энтках
конфиденциальность|конфидэнци+альность
конфиденциальности|конфидэнци+альности
конфиденциальностью|конфидэнци+альностью
крепдешинчик|крепдэш+инчик
крепдешинчика|крепдэш+инчика
крепдешинчику|крепдэш+инчику
крепдешинчиком|крепдэш+инчиком
крепдешинчике|крепдэш+инчике
крепдешинчики|крепдэш+инчики
крепдешинчиков|крепдэш+инчиков
крепдешинчикам|крепдэш+инчикам
крепдешинчиками|крепдэш+инчиками
крепдешинчиках|крепдэш+инчиках
крепдешиновый|крепдэш+иновый
лазерник|л+азэрник
лазерника|л+азэрника
лазернику|л+азэрнику
лазерником|л+азэрником
лазернике|л+азэрнике
лазерники|л+азэрники
лазерников|л+азэрников
лазерникам|л+азэрникам
лазерниками|л+азэрниками
лазерниках|л+азэрниках
лазерникой|л+азэрникой
лазерникою|л+азэрникою
лазерникнуть|л+азэрникнуть
лазерникну|л+азэрникну
лазерникнем|л+азэрникнем
лазерникнешь|л+азэрникнешь
лазерникнете|л+азэрникнете
лазерникнет|л+азэрникнет
лазерникнут|л+азэрникнут
лазерникнул|л+азэрникнул
лазерникла|л+азэрникла
лазерникнула|л+азэрникнула
лазерникло|л+азэрникло
лазерникнуло|л+азэрникнуло
лазерникли|л+азэрникли
лазерникнули|л+азэрникнули
лазерникни|л+азэрникни
лазерникните|л+азэрникните
лазерникнущий|л+азэрникнущий
лазерникнущего|л+азэрникнущего
лазерникнущему|л+азэрникнущему
лазерникнущим|л+азэрникнущим
лазерникнущем|л+азэрникнущем
лазерникнущая|л+азэрникнущая
лазерникнущей|л+азэрникнущей
лазерникнущую|л+азэрникнущую
лазерникнущею|л+азэрникнущею
лазерникнущее|л+азэрникнущее
лазерникнущие|л+азэрникнущие
лазерникнущих|л+азэрникнущих
лазерникнущими|л+азэрникнущими
лазерникнувший|л+азэрникнувший
лазерникнувшего|л+азэрникнувшего
лазерникнувшему|л+азэрникнувшему
лазерникнувшим|л+азэрникнувшим
лазерникнувшем|л+азэрникнувшем
лазерникнувшая|л+азэрникнувшая
лазерникнувшей|л+азэрникнувшей
лазерникнувшую|л+азэрникнувшую
лазерникнувшею|л+азэрникнувшею
лазерникнувшее|л+азэрникнувшее
лазерникнувшие|л+азэрникнувшие
лазерникнувших|л+азэрникнувших
лазерникнувшими|л+азэрникнувшими
лазерникнув|л+азэрникнув
лазерникнувши|л+азэрникнувши
лазерный|л+азэрный
лазерного|л+азэрного
лазерному|л+азэрному
лазерным|л+азэрным
лазерном|л+азэрном
лазерная|л+азэрная
лазерной|л+азэрной
лазерную|л+азэрную
лазерною|л+азэрною
лазерное|л+азэрное
лазерные|л+азэрные
лазерных|л+азэрных
лазерными|л+азэрными
лазеротерапия|лазэротерап+ия
лазеротерапии|лазэротерап+ии
лазеротерапию|лазэротерап+ию
лазеротерапией|лазэротерап+ией
лазеротерапиею|лазэротерап+иею
лазеротерапий|лазэротерап+ий
лазеротерапиям|лазэротерап+иям
лазеротерапиями|лазэротерап+иями
лазеротерапиях|лазэротерап+иях
лазерщик|л+азэрщик
лазерщика|л+азэрщика
лазерщику|л+азэрщику
лазерщиком|л+азэрщиком
лазерщике|л+азэрщике
лазерщики|л+азэрщики
лазерщиков|л+азэрщиков
лазерщикам|л+азэрщикам
лазерщиками|л+азэрщиками
лазерщиках|л+азэрщиках
коменеджер|ком+энэджер
коменеджера|ком+энэджера
коменеджеру|ком+энэджеру
коменеджером|ком+энэджером
коменеджере|ком+энэджере
коменеджеры|ком+энэджеры
коменеджеров|ком+энэджеров
коменеджерам|ком+энэджерам
коменеджерами|ком+энэджерами
коменеджерах|ком+энэджерах
коменеджмент|ком+энэджмент
коменеджмента|ком+энэджмента
коменеджменту|ком+энэджменту
коменеджментом|ком+энэджментом
коменеджменте|ком+энэджменте
коменеджменты|ком+энэджменты
коменеджментов|ком+энэджментов
коменеджментам|ком+энэджментам
коменеджментами|ком+энэджментами
коменеджментах|ком+энэджментах
менеджеризм|мэнэджер+изм
менеджеризма|мэнэджер+изма
менеджеризму|мэнэджер+изму
менеджеризмом|мэнэджер+измом
менеджеризме|мэнэджер+изме
менеджеризмы|мэнэджер+измы
менеджеризмов|мэнэджер+измов
менеджеризмам|мэнэджер+измам
менеджеризмами|мэнэджер+измами
менеджеризмах|мэнэджер+измах
менеджерский|м+энэджерский
менеджерского|м+энэджерского
менеджерскому|м+энэджерскому
менеджерским|м+энэджерским
менеджерском|м+энэджерском
менеджерская|м+энэджерская
менеджерской|м+энэджерской
менеджерскую|м+энэджерскую
менеджерскою|м+энэджерскою
менеджерское|м+энэджерское
менеджерские|м+энэджерские
менеджерских|м+энэджерских
менеджерскими|м+энэджерскими
менеджировать|мэнэдж+ировать
менеджирую|мэнэдж+ирую
менеджируем|мэнэдж+ируем
менеджируешь|мэнэдж+ируешь
менеджируете|мэнэдж+ируете
менеджирует|мэнэдж+ирует
менеджируют|мэнэдж+ируют
менеджировал|мэнэдж+ировал
менеджировала|мэнэдж+ировала
менеджировало|мэнэдж+ировало
менеджировали|мэнэдж+ировали
менеджируй|мэнэдж+ируй
менеджируйте|мэнэдж+ируйте
менеджирующий|мэнэдж+ирующий
менеджирующего|мэнэдж+ирующего
менеджирующему|мэнэдж+ирующему
менеджирующим|мэнэдж+ирующим
менеджирующем|мэнэдж+ирующем
менеджирующая|мэнэдж+ирующая
менеджирующей|мэнэдж+ирующей
менеджирующую|мэнэдж+ирующую
менеджирующею|мэнэдж+ирующею
менеджирующее|мэнэдж+ирующее
менеджирующие|мэнэдж+ирующие
менеджирующих|мэнэдж+ирующих
менеджирующими|мэнэдж+ирующими
менеджировавший|мэнэдж+ировавший
менеджировавшего|мэнэдж+ировавшего
менеджировавшему|мэнэдж+ировавшему
менеджировавшим|мэнэдж+ировавшим
менеджировавшем|мэнэдж+ировавшем
менеджировавшая|мэнэдж+ировавшая
менеджировавшей|мэнэдж+ировавшей
менеджировавшую|мэнэдж+ировавшую
менеджировавшею|мэнэдж+ировавшею
менеджировавшее|мэнэдж+ировавшее
менеджировавшие|мэнэдж+ировавшие
менеджировавших|мэнэдж+ировавших
менеджировавшими|мэнэдж+ировавшими
менеджируемый|мэнэдж+ируемый
менеджируемого|мэнэдж+ируемого
менеджируемому|мэнэдж+ируемому
менеджируемым|мэнэдж+ируемым
менеджируемом|мэнэдж+ируемом
менеджируемая|мэнэдж+ируемая
менеджируемой|мэнэдж+ируемой
менеджируемую|мэнэдж+ируемую
менеджируемою|мэнэдж+ируемою
менеджируемое|мэнэдж+ируемое
менеджируемые|мэнэдж+ируемые
менеджируемых|мэнэдж+ируемых
менеджируемыми|мэнэдж+ируемыми
менеджированный|мэнэдж+ированный
менеджированного|мэнэдж+ированного
менеджированному|мэнэдж+ированному
менеджированным|мэнэдж+ированным
менеджированном|мэнэдж+ированном
менеджированная|мэнэдж+ированная
менеджированной|мэнэдж+ированной
менеджированную|мэнэдж+ированную
менеджированною|мэнэдж+ированною
менеджированное|мэнэдж+ированное
менеджированные|мэнэдж+ированные
менеджированных|мэнэдж+ированных
менеджированными|мэнэдж+ированными
менеджируя|мэнэдж+ируя
менеджировавши|мэнэдж+ировавши
менеджируема|мэнэдж+ируема
менеджируемо|мэнэдж+ируемо
менеджируемы|мэнэдж+ируемы
менеджирован|мэнэдж+ирован
менеджирована|мэнэдж+ирована
менеджировано|мэнэдж+ировано
менеджированы|мэнэдж+ированы
менеджируемте|мэнэдж+ируемте
менеджировав|мэнэдж+ировав
менеджировати|мэнэдж+ировати
менеджироватью|мэнэдж+ироватью
менеджироватей|мэнэдж+ироватей
менеджироватям|мэнэдж+ироватям
менеджироватями|мэнэдж+ироватями
менеджироватях|мэнэдж+ироватях
авиамоделизм|авиамодэл+изм
авиамоделизма|авиамодэл+изма
авиамоделизму|авиамодэл+изму
авиамоделизмом|авиамодэл+измом
авиамоделизме|авиамодэл+изме
авиамоделизмы|авиамодэл+измы
авиамоделизмов|авиамодэл+измов
авиамоделизмам|авиамодэл+измам
авиамоделизмами|авиамодэл+измами
авиамоделизмах|авиамодэл+измах
моделирование|модэл+ирование
моделированье|модэл+ированье
моделирования|модэл+ирования
моделированья|модэл+ированья
моделированию|модэл+ированию
моделированью|модэл+ированью
моделированием|модэл+ированием
моделированьем|модэл+ированьем
моделировании|модэл+ировании
моделированьи|модэл+ированьи
моделирований|модэл+ирований
моделированиям|модэл+ированиям
моделированьям|модэл+ированьям
моделированиями|модэл+ированиями
моделированьями|модэл+ированьями
моделированиях|модэл+ированиях
моделированьях|модэл+ированьях
моделироваться|модэл+ироваться
моделироваюсь|модэл+ироваюсь
моделироваемся|модэл+ироваемся
моделироваешься|модэл+ироваешься
моделироваетесь|модэл+ироваетесь
моделировается|модэл+ировается
моделироваются|модэл+ироваются
моделировался|модэл+ировался
моделировалась|модэл+ировалась
моделировалось|модэл+ировалось
моделировались|модэл+ировались
моделировайся|модэл+ировайся
моделировайтесь|модэл+ировайтесь
моделировающийся|модэл+ировающийся
моделировающегося|модэл+ировающегося
моделировающемуся|модэл+ировающемуся
моделировающимся|модэл+ировающимся
моделировающемся|модэл+ировающемся
моделировающаяся|модэл+ировающаяся
моделировающейся|модэл+ировающейся
моделировающуюся|модэл+ировающуюся
моделировающеюся|модэл+ировающеюся
моделировающееся|модэл+ировающееся
моделировающиеся|модэл+ировающиеся
моделировающихся|модэл+ировающихся
моделировающимися|модэл+ировающимися
моделировавшийся|модэл+ировавшийся
моделировавшегося|модэл+ировавшегося
моделировавшемуся|модэл+ировавшемуся
моделировавшимся|модэл+ировавшимся
моделировавшемся|модэл+ировавшемся
моделировавшаяся|модэл+ировавшаяся
моделировавшейся|модэл+ировавшейся
моделировавшуюся|модэл+ировавшуюся
моделировавшеюся|модэл+ировавшеюся
моделировавшееся|модэл+ировавшееся
моделировавшиеся|модэл+ировавшиеся
моделировавшихся|модэл+ировавшихся
моделировавшимися|модэл+ировавшимися
моделироваясь|модэл+ироваясь
моделировавшись|модэл+ировавшись
моделироватиться|модэл+ироватиться
моделироватился|модэл+ироватился
моделироватилась|модэл+ироватилась
моделироватилось|модэл+ироватилось
моделироватились|модэл+ироватились
моделировачусь|модэл+ировачусь
моделироватимся|модэл+ироватимся
моделироватишься|модэл+ироватишься
моделироватитесь|модэл+ироватитесь
моделироватится|модэл+ироватится
моделироватятся|модэл+ироватятся
моделироватимтесь|модэл+ироватимтесь
моделироватьтесь|модэл+ироватьтесь
моделироватившийся|модэл+ироватившийся
моделироватившегося|модэл+ироватившегося
моделироватившемуся|модэл+ироватившемуся
моделироватившимся|модэл+ироватившимся
моделироватившемся|модэл+ироватившемся
моделироватившаяся|модэл+ироватившаяся
моделироватившейся|модэл+ироватившейся
моделироватившуюся|модэл+ироватившуюся
моделироватившеюся|модэл+ироватившеюся
моделироватившееся|модэл+ироватившееся
моделироватившиеся|модэл+ироватившиеся
моделироватившихся|модэл+ироватившихся
моделироватившимися|модэл+ироватившимися
моделироватившись|модэл+ироватившись
моделировка|модэлир+овка
моделировки|модэлир+овки
моделировке|модэлир+овке
моделировку|модэлир+овку
моделировкой|модэлир+овкой
моделировкою|модэлир+овкою
моделировок|модэлир+овок
моделировкам|модэлир+овкам
моделировками|модэлир+овками
моделировках|модэлир+овках
моделировщик|модэлир+овщик
моделировщика|модэлир+овщика
моделировщику|модэлир+овщику
моделировщиком|модэлир+овщиком
моделировщике|модэлир+овщике
моделировщики|модэлир+овщики
моделировщиков|модэлир+овщиков
моделировщикам|модэлир+овщикам
моделировщиками|модэлир+овщиками
моделировщиках|модэлир+овщиках
моделист|модэл+ист
моделиста|модэл+иста
моделисту|модэл+исту
моделистом|модэл+истом
моделисте|модэл+исте
моделисты|модэл+исты
моделистов|модэл+истов
моделистам|модэл+истам
моделистами|модэл+истами
моделистах|модэл+истах
модель|мод+эль
модели|мод+эли
моделью|мод+элью
моделей|мод+элей
моделям|мод+элям
моделями|мод+элями
моделях|мод+элях
смоделировать|смодэл+ировать
смоделировал|смодэл+ировал
смоделировала|смодэл+ировала
смоделировало|смодэл+ировало
смоделировали|смодэл+ировали
смоделирую|смодэл+ирую
смоделируем|смодэл+ируем
смоделируешь|смодэл+ируешь
смоделируете|смодэл+ируете
смоделирует|смодэл+ирует
смоделируют|смодэл+ируют
смоделируемте|смодэл+ируемте
смоделируй|смодэл+ируй
смоделируйте|смодэл+ируйте
смоделировавший|смодэл+ировавший
смоделировавшего|смодэл+ировавшего
смоделировавшему|смодэл+ировавшему
смоделировавшим|смодэл+ировавшим
смоделировавшем|смодэл+ировавшем
смоделировавшая|смодэл+ировавшая
смоделировавшей|смодэл+ировавшей
смоделировавшую|смодэл+ировавшую
смоделировавшею|смодэл+ировавшею
смоделировавшее|смодэл+ировавшее
смоделировавшие|смодэл+ировавшие
смоделировавших|смодэл+ировавших
смоделировавшими|смодэл+ировавшими
смоделированный|смодэл+ированный
смоделированного|смодэл+ированного
смоделированному|смодэл+ированному
смоделированным|смодэл+ированным
смоделированном|смодэл+ированном
смоделированная|смодэл+ированная
смоделированной|смодэл+ированной
смоделированную|смодэл+ированную
смоделированною|смодэл+ированною
смоделированное|смодэл+ированное
смоделированные|смодэл+ированные
смоделированных|смодэл+ированных
смоделированными|смодэл+ированными
смоделировав|смодэл+ировав
смоделировавши|смодэл+ировавши
смоделирован|смодэл+ирован
смоделирована|смодэл+ирована
смоделировано|смодэл+ировано
смоделированы|смодэл+ированы
орхидейный|орхид+эйный
орхидейного|орхид+эйного
орхидейному|орхид+эйному
орхидейным|орхид+эйным
орхидейном|орхид+эйном
орхидейная|орхид+эйная
орхидейной|орхид+эйной
орхидейную|орхид+эйную
орхидейною|орхид+эйною
орхидейное|орхид+эйное
орхидейные|орхид+эйные
орхидейных|орхид+эйных
орхидейными|орхид+эйными
пантерный|пант+эрный
пантерного|пант+эрного
пантерному|пант+эрному
пантерным|пант+эрным
пантерном|пант+эрном
пантерная|пант+эрная
пантерной|пант+эрной
пантерную|пант+эрную
пантерною|пант+эрною
пантерное|пант+эрное
пантерные|пант+эрные
пантерных|пант+эрных
пантерными|пант+эрными
претенциозность|претэнци+озность
претенциозности|претэнци+озности
претенциозностью|претэнци+озностью
претенциозностей|претэнци+озностей
претенциозностям|претэнци+озностям
претенциозностями|претэнци+озностями
претенциозностях|претэнци+озностях
провиденциализм|провидэнциал+изм
провиденциализма|провидэнциал+изма
провиденциализму|провидэнциал+изму
провиденциализмом|провидэнциал+измом
провиденциализме|провидэнциал+изме
провиденциализмы|провидэнциал+измы
провиденциализмов|провидэнциал+измов
провиденциализмам|провидэнциал+измам
провиденциализмами|провидэнциал+измами
провиденциализмах|провидэнциал+измах
протежирование|протэж+ирование
протежированье|протэж+ированье
протежирования|протэж+ирования
протежированья|протэж+ированья
протежированию|протэж+ированию
протежированью|протэж+ированью
протежированием|протэж+ированием
протежированьем|протэж+ированьем
протежировании|протэж+ировании
протежировать|протэж+ировать
протежирую|протэж+ирую
протежируем|протэж+ируем
протежируешь|протэж+ируешь
протежируете|протэж+ируете
протежирует|протэж+ирует
протежируют|протэж+ируют
протежировал|протэж+ировал
протежировала|протэж+ировала
протежировало|протэж+ировало
протежировали|протэж+ировали
протежируй|протэж+ируй
протежируйте|протэж+ируйте
протежирующий|протэж+ирующий
протежирующего|протэж+ирующего
протежирующему|протэж+ирующему
протежирующим|протэж+ирующим
протежирующем|протэж+ирующем
протежирующая|протэж+ирующая
протежирующей|протэж+ирующей
протежирующую|протэж+ирующую
протежирующею|протэж+ирующею
протежирующее|протэж+ирующее
протежирующие|протэж+ирующие
протежирующих|протэж+ирующих
протежирующими|протэж+ирующими
протежировавший|протэж+ировавший
протежировавшего|протэж+ировавшего
протежировавшему|протэж+ировавшему
протежировавшим|протэж+ировавшим
протежировавшем|протэж+ировавшем
протежировавшая|протэж+ировавшая
протежировавшей|протэж+ировавшей
протежировавшую|протэж+ировавшую
протежировавшею|протэж+ировавшею
протежировавшее|протэж+ировавшее
протежировавшие|протэж+ировавшие
протежировавших|протэж+ировавших
протежировавшими|протэж+ировавшими
протежируемый|протэж+ируемый
протежируемого|протэж+ируемого
протежируемому|протэж+ируемому
протежируемым|протэж+ируемым
протежируемом|протэж+ируемом
протежируемая|протэж+ируемая
протежируемой|протэж+ируемой
протежируемую|протэж+ируемую
протежируемою|протэж+ируемою
протежируемое|протэж+ируемое
протежируемые|протэж+ируемые
протежируемых|протэж+ируемых
протежируемыми|протэж+ируемыми
протежированный|протэж+ированный
протежированного|протэж+ированного
протежированному|протэж+ированному
протежированным|протэж+ированным
протежированном|протэж+ированном
протежированная|протэж+ированная
протежированной|протэж+ированной
протежированную|протэж+ированную
протежированною|протэж+ированною
протежированное|протэж+ированное
протежированные|протэж+ированные
протежированных|протэж+ированных
протежированными|протэж+ированными
протежируя|протэж+ируя
протежировавши|протэж+ировавши
протежируема|протэж+ируема
протежируемо|протэж+ируемо
протежируемы|протэж+ируемы
протежирован|протэж+ирован
протежирована|протэж+ирована
протежировано|протэж+ировано
протежированы|протэж+ированы
протезирование|протэз+ирование
протезированье|протэз+ированье
протезирования|протэз+ирования
протезированья|протэз+ированья
протезированию|протэз+ированию
протезированью|протэз+ированью
протезированием|протэз+ированием
протезированьем|протэз+ированьем
протезировании|протэз+ировании
протезированьи|протэз+ированьи
протезирований|протэз+ирований
протезированиям|протэз+ированиям
протезированьям|протэз+ированьям
протезированиями|протэз+ированиями
протезированьями|протэз+ированьями
протезированиях|протэз+ированиях
протезированьях|протэз+ированьях
протезировать|протэз+ировать
протезирую|протэз+ирую
протезируем|протэз+ируем
протезируешь|протэз+ируешь
протезируете|протэз+ируете
протезирует|протэз+ирует
протезируют|протэз+ируют
протезировал|протэз+ировал
протезировала|протэз+ировала
протезировало|протэз+ировало
протезировали|протэз+ировали
протезируй|протэз+ируй
протезируйте|протэз+ируйте
протезирующий|протэз+ирующий
протезирующего|протэз+ирующего
протезирующему|протэз+ирующему
протезирующим|протэз+ирующим
протезирующем|протэз+ирующем
протезирующая|протэз+ирующая
протезирующей|протэз+ирующей
протезирующую|протэз+ирующую
протезирующею|протэз+ирующею
протезирующее|протэз+ирующее
протезирующие|протэз+ирующие
протезирующих|протэз+ирующих
протезирующими|протэз+ирующими
протезировавший|протэз+ировавший
протезировавшего|протэз+ировавшего
протезировавшему|протэз+ировавшему
протезировавшим|протэз+ировавшим
протезировавшем|протэз+ировавшем
протезировавшая|протэз+ировавшая
протезировавшей|протэз+ировавшей
протезировавшую|протэз+ировавшую
протезировавшею|протэз+ировавшею
протезировавшее|протэз+ировавшее
протезировавшие|протэз+ировавшие
протезировавших|протэз+ировавших
протезировавшими|протэз+ировавшими
протезируемый|протэз+ируемый
протезируемого|протэз+ируемого
протезируемому|протэз+ируемому
протезируемым|протэз+ируемым
протезируемом|протэз+ируемом
протезируемая|протэз+ируемая
протезируемой|протэз+ируемой
протезируемую|протэз+ируемую
протезируемою|протэз+ируемою
протезируемое|протэз+ируемое
протезируемые|протэз+ируемые
протезируемых|протэз+ируемых
протезируемыми|протэз+ируемыми
протезированный|протэз+ированный
протезированного|протэз+ированного
протезированному|протэз+ированному
протезированным|протэз+ированным
протезированном|протэз+ированном
протезированная|протэз+ированная
протезированной|протэз+ированной
протезированную|протэз+ированную
протезированною|протэз+ированною
протезированное|протэз+ированное
протезированные|протэз+ированные
протезированных|протэз+ированных
протезированными|протэз+ированными
протезируя|протэз+ируя
протезировавши|протэз+ировавши
протезируема|протэз+ируема
протезируемо|протэз+ируемо
протезируемы|протэз+ируемы
протезирован|протэз+ирован
протезирована|протэз+ирована
протезировано|протэз+ировано
протезированы|протэз+ированы
эктопротез|эктопрот+эз
эктопротеза|эктопрот+эза
эктопротезу|эктопрот+эзу
эктопротезом|эктопрот+эзом
эктопротезе|эктопрот+эзе
эктопротезы|эктопрот+эзы
эктопротезов|эктопрот+эзов
эктопротезам|эктопрот+эзам
эктопротезами|эктопрот+эзами
эктопротезах|эктопрот+эзах
эндопротез|эндопрот+эз
эндопротеза|эндопрот+эза
эндопротезу|эндопрот+эзу
эндопротезом|эндопрот+эзом
эндопротезе|эндопрот+эзе
эндопротезы|эндопрот+эзы
эндопротезов|эндопрот+эзов
эндопротезам|эндопрот+эзам
эндопротезами|эндопрот+эзами
эндопротезах|эндопрот+эзах
протезист|протэз+ист
протезиста|протэз+иста
протезисту|протэз+исту
протезистом|протэз+истом
протезисте|протэз+исте
протезисты|протэз+исты
протезистов|протэз+истов
протезистам|протэз+истам
протезистами|протэз+истами
протезистах|протэз+истах
протектор|прот+эктор
протектора|прот+эктора
протектору|прот+эктору
протектором|прот+эктором
протекторе|прот+экторе
протекторы|прот+экторы
протекторов|прот+экторов
протекторам|прот+экторам
протекторами|прот+экторами
протекторах|прот+экторах
протекционизм|протэкцион+изм
протекционизма|протэкцион+изма
протекционизму|протэкцион+изму
протекционизмом|протэкцион+измом
протекционизме|протэкцион+изме
протекционизмы|протэкцион+измы
протекционизмов|протэкцион+измов
протекционизмам|протэкцион+измам
протекционизмами|протэкцион+измами
протекционизмах|протэкцион+измах
протекционный|протэкци+онный
протекционного|протэкци+онного
протекционному|протэкци+онному
протекционным|протэкци+онным
протекционном|протэкци+онном
протекционная|протэкци+онная
протекционной|протэкци+онной
протекционную|протэкци+онную
протекционною|протэкци+онною
протекционное|протэкци+онное
протекционные|протэкци+онные
протекционных|протэкци+онных
протекционными|протэкци+онными
протекционен|протэкци+онен
протекционна|протэкци+онна
протекционно|протэкци+онно
протекционны|протэкци+онны
протекционнее|протэкци+оннее
протекционней|протэкци+онней
сентенциальный|сэнт+энциальный
сентенциального|сэнт+энциального
сентенциальному|сэнт+энциальному
сентенциальным|сэнт+энциальным
сентенциальном|сэнт+энциальном
сентенциальная|сэнт+энциальная
сентенциальной|сэнт+энциальной
сентенциальную|сэнт+энциальную
сентенциальною|сэнт+энциальною
сентенциальное|сэнт+энциальное
сентенциальные|сэнт+энциальные
сентенциальных|сэнт+энциальных
сентенциальными|сэнт+энциальными
сентенциозно|сэнтэнци+озно
сентенциозного|сэнтэнци+озного
сентенциозному|сэнтэнци+озному
сентенциозным|сэнтэнци+озным
сентенциозном|сэнтэнци+озном
сентенциозная|сэнтэнци+озная
сентенциозной|сэнтэнци+озной
сентенциозную|сэнтэнци+озную
сентенциозною|сэнтэнци+озною
сентенциозное|сэнтэнци+озное
сентенциозные|сэнтэнци+озные
сентенциозных|сэнтэнци+озных
сентенциозными|сэнтэнци+озными
сентенциозен|сэнтэнци+озен
сентенциозна|сэнтэнци+озна
сентенциозны|сэнтэнци+озны
сентенциознее|сэнтэнци+ознее
сентенциозней|сэнтэнци+озней
сентенциозность|сэнтэнци+озность
сентенциозности|сэнтэнци+озности
сентенциозностью|сэнтэнци+озностью
сентенциозностей|сэнтэнци+озностей
сентенциозностям|сэнтэнци+озностям
сентенциозностями|сэнтэнци+озностями
сентенциозностях|сэнтэнци+озностях
сентенциозный|сэнтэнци+озный
синтезатор|синтэз+атор
синтезатора|синтэз+атора
синтезатору|синтэз+атору
синтезатором|синтэз+атором
синтезаторе|синтэз+аторе
синтезаторы|синтэз+аторы
синтезаторов|синтэз+аторов
синтезаторам|синтэз+аторам
синтезаторами|синтэз+аторами
синтезаторах|синтэз+аторах
синтезировать|синтэз+ировать
синтезировал|синтэз+ировал
синтезировала|синтэз+ировала
синтезировало|синтэз+ировало
синтезировали|синтэз+ировали
синтезирую|синтэз+ирую
синтезируем|синтэз+ируем
синтезируешь|синтэз+ируешь
синтезируете|синтэз+ируете
синтезирует|синтэз+ирует
синтезируют|синтэз+ируют
синтезируемте|синтэз+ируемте
синтезируй|синтэз+ируй
синтезируйте|синтэз+ируйте
синтезировавший|синтэз+ировавший
синтезировавшего|синтэз+ировавшего
синтезировавшему|синтэз+ировавшему
синтезировавшим|синтэз+ировавшим
синтезировавшем|синтэз+ировавшем
синтезировавшая|синтэз+ировавшая
синтезировавшей|синтэз+ировавшей
синтезировавшую|синтэз+ировавшую
синтезировавшею|синтэз+ировавшею
синтезировавшее|синтэз+ировавшее
синтезировавшие|синтэз+ировавшие
синтезировавших|синтэз+ировавших
синтезировавшими|синтэз+ировавшими
синтезированный|синтэз+ированный
синтезированного|синтэз+ированного
синтезированному|синтэз+ированному
синтезированным|синтэз+ированным
синтезированном|синтэз+ированном
синтезированная|синтэз+ированная
синтезированной|синтэз+ированной
синтезированную|синтэз+ированную
синтезированною|синтэз+ированною
синтезированное|синтэз+ированное
синтезированные|синтэз+ированные
синтезированных|синтэз+ированных
синтезированными|синтэз+ированными
синтезировав|синтэз+ировав
синтезировавши|синтэз+ировавши
синтезирующий|синтэз+ирующий
синтезирующего|синтэз+ирующего
синтезирующему|синтэз+ирующему
синтезирующим|синтэз+ирующим
синтезирующем|синтэз+ирующем
синтезирующая|синтэз+ирующая
синтезирующей|синтэз+ирующей
синтезирующую|синтэз+ирующую
синтезирующею|синтэз+ирующею
синтезирующее|синтэз+ирующее
синтезирующие|синтэз+ирующие
синтезирующих|синтэз+ирующих
синтезирующими|синтэз+ирующими
синтезируемый|синтэз+ируемый
синтезируемого|синтэз+ируемого
синтезируемому|синтэз+ируемому
синтезируемым|синтэз+ируемым
синтезируемом|синтэз+ируемом
синтезируемая|синтэз+ируемая
синтезируемой|синтэз+ируемой
синтезируемую|синтэз+ируемую
синтезируемою|синтэз+ируемою
синтезируемое|синтэз+ируемое
синтезируемые|синтэз+ируемые
синтезируемых|синтэз+ируемых
синтезируемыми|синтэз+ируемыми
синтезируя|синтэз+ируя
синтезируема|синтэз+ируема
синтезируемо|синтэз+ируемо
синтезируемы|синтэз+ируемы
синтезирован|синтэз+ирован
синтезирована|синтэз+ирована
синтезировано|синтэз+ировано
синтезированы|синтэз+ированы
синтетик|синт+этик
синтетику|синт+этику
синтетиком|синт+этиком
синтетике|синт+этике
синтетики|синт+этики
синтетиков|синт+этиков
синтетикам|синт+этикам
синтетиками|синт+этиками
синтетиках|синт+этиках
синтетикой|синт+этикой
синтетикою|синт+этикою
синтетика|синт+этика
синтетически|синтэт+ически
синтетичёска|синтэт+ичёска
синтетичёски|синтэт+ичёски
синтетичёске|синтэт+ичёске
синтетичёску|синтэт+ичёску
синтетичёской|синтэт+ичёской
синтетичёскою|синтэт+ичёскою
синтетичёсок|синтэт+ичёсок
синтетичёскам|синтэт+ичёскам
синтетичёсками|синтэт+ичёсками
синтетичёсках|синтэт+ичёсках
синтетическа|синтэт+ическа
синтетическе|синтэт+ическе
синтетическу|синтэт+ическу
синтетической|синтэт+ической
синтетическою|синтэт+ическою
синтетичесок|синтэт+ичесок
синтетическам|синтэт+ическам
синтетическами|синтэт+ическами
синтетическах|синтэт+ическах
синтетическ|синтэт+ическ
синтетическом|синтэт+ическом
синтетическов|синтэт+ическов
синтетический|синтэт+ический
синтетического|синтэт+ического
синтетическому|синтэт+ическому
синтетическим|синтэт+ическим
синтетическая|синтэт+ическая
синтетическую|синтэт+ическую
синтетическое|синтэт+ическое
синтетические|синтэт+ические
синтетических|синтэт+ических
синтетическими|синтэт+ическими
сонетик|сон+этик
сонетика|сон+этика
сонетику|сон+этику
сонетиком|сон+этиком
сонетике|сон+этике
сонетики|сон+этики
сонетиков|сон+этиков
сонетикам|сон+этикам
сонетиками|сон+этиками
сонетиках|сон+этиках
сонетный|сон+этный
сонетного|сон+этного
сонетному|сон+этному
сонетным|сон+этным
сонетном|сон+этном
сонетная|сон+этная
сонетной|сон+этной
сонетную|сон+этную
сонетною|сон+этною
сонетное|сон+этное
сонетные|сон+этные
сонетных|сон+этных
сонетными|сон+этными
сонетен|сон+этен
сонетна|сон+этна
сонетно|сон+этно
сонетны|сон+этны
сонетнее|сон+этнее
сонетней|сон+этней
стрессово|стр+эссово
стрессового|стр+эссового
стрессовому|стр+эссовому
стрессовым|стр+эссовым
стрессовом|стр+эссовом
стрессовая|стр+эссовая
стрессовой|стр+эссовой
стрессовую|стр+эссовую
стрессовою|стр+эссовою
стрессовое|стр+эссовое
стрессовые|стр+эссовые
стрессовых|стр+эссовых
стрессовыми|стр+эссовыми
стрессова|стр+эссова
стрессовы|стр+эссовы
стрессовее|стр+эссовее
стрессовей|стр+эссовей
стрессову|стр+эссову
стрессове|стр+эссове
стрессовость|стр+эссовость
стрессовости|стр+эссовости
стрессовостью|стр+эссовостью
стрессовостей|стр+эссовостей
стрессовостям|стр+эссовостям
стрессовостями|стр+эссовостями
стрессовостях|стр+эссовостях
стрессовостить|стр+эссовостить
стрессовощу|стр+эссовощу
стрессовостим|стр+эссовостим
стрессовостишь|стр+эссовостишь
стрессовостите|стр+эссовостите
стрессовостит|стр+эссовостит
стрессовостят|стр+эссовостят
стрессовостил|стр+эссовостил
стрессовостила|стр+эссовостила
стрессовостило|стр+эссовостило
стрессовостили|стр+эссовостили
стрессовостьте|стр+эссовостьте
стрессовостящий|стр+эссовостящий
стрессовостящего|стр+эссовостящего
стрессовостящему|стр+эссовостящему
стрессовостящим|стр+эссовостящим
стрессовостящем|стр+эссовостящем
стрессовостящая|стр+эссовостящая
стрессовостящей|стр+эссовостящей
стрессовостящую|стр+эссовостящую
стрессовостящею|стр+эссовостящею
стрессовостящее|стр+эссовостящее
стрессовостящие|стр+эссовостящие
стрессовостящих|стр+эссовостящих
стрессовостящими|стр+эссовостящими
стрессовостивший|стр+эссовостивший
стрессовостившего|стр+эссовостившего
стрессовостившему|стр+эссовостившему
стрессовостившим|стр+эссовостившим
стрессовостившем|стр+эссовостившем
стрессовостившая|стр+эссовостившая
стрессовостившей|стр+эссовостившей
стрессовостившую|стр+эссовостившую
стрессовостившею|стр+эссовостившею
стрессовостившее|стр+эссовостившее
стрессовостившие|стр+эссовостившие
стрессовостивших|стр+эссовостивших
стрессовостившими|стр+эссовостившими
стрессовостимый|стр+эссовостимый
стрессовостимого|стр+эссовостимого
стрессовостимому|стр+эссовостимому
стрессовостимым|стр+эссовостимым
стрессовостимом|стр+эссовостимом
стрессовостимая|стр+эссовостимая
стрессовостимой|стр+эссовостимой
стрессовостимую|стр+эссовостимую
стрессовостимою|стр+эссовостимою
стрессовостимое|стр+эссовостимое
стрессовостимые|стр+эссовостимые
стрессовостимых|стр+эссовостимых
стрессовостимыми|стр+эссовостимыми
стрессовощенный|стр+эссовощенный
стрессовощенного|стр+эссовощенного
стрессовощенному|стр+эссовощенному
стрессовощенным|стр+эссовощенным
стрессовощенном|стр+эссовощенном
стрессовощенная|стр+эссовощенная
стрессовощенной|стр+эссовощенной
стрессовощенную|стр+эссовощенную
стрессовощенною|стр+эссовощенною
стрессовощенное|стр+эссовощенное
стрессовощенные|стр+эссовощенные
стрессовощенных|стр+эссовощенных
стрессовощенными|стр+эссовощенными
стрессовостя|стр+эссовостя
стрессовостив|стр+эссовостив
стрессовостивши|стр+эссовостивши
стрессовостима|стр+эссовостима
стрессовостимо|стр+эссовостимо
стрессовостимы|стр+эссовостимы
стрессовощен|стр+эссовощен
стрессовощена|стр+эссовощена
стрессовощено|стр+эссовощено
стрессовощены|стр+эссовощены
стрессовый|стр+эссовый
стрессоустойчивость|стрэссоуст+ойчивость
стрессоустойчивости|стрэссоуст+ойчивости
стрессоустойчивостью|стрэссоуст+ойчивостью
стрессоустойчивостей|стрэссоуст+ойчивостей
стрессоустойчивостям|стрэссоуст+ойчивостям
стрессоустойчивостями|стрэссоуст+ойчивостями
стрессоустойчивостях|стрэссоуст+ойчивостях
стрессоустойчивостить|стрэссоуст+ойчивостить
стрессоустойчивощу|стрэссоуст+ойчивощу
стрессоустойчивостим|стрэссоуст+ойчивостим
стрессоустойчивостишь|стрэссоуст+ойчивостишь
стрессоустойчивостите|стрэссоуст+ойчивостите
стрессоустойчивостит|стрэссоуст+ойчивостит
стрессоустойчивостят|стрэссоуст+ойчивостят
стрессоустойчивостил|стрэссоуст+ойчивостил
стрессоустойчивостила|стрэссоуст+ойчивостила
стрессоустойчивостило|стрэссоуст+ойчивостило
стрессоустойчивостили|стрэссоуст+ойчивостили
стрессоустойчивостьте|стрэссоуст+ойчивостьте
стрессоустойчивостящий|стрэссоуст+ойчивостящий
стрессоустойчивостящего|стрэссоуст+ойчивостящего
стрессоустойчивостящему|стрэссоуст+ойчивостящему
стрессоустойчивостящим|стрэссоуст+ойчивостящим
стрессоустойчивостящем|стрэссоуст+ойчивостящем
стрессоустойчивостящая|стрэссоуст+ойчивостящая
стрессоустойчивостящей|стрэссоуст+ойчивостящей
стрессоустойчивостящую|стрэссоуст+ойчивостящую
стрессоустойчивостящею|стрэссоуст+ойчивостящею
стрессоустойчивостящее|стрэссоуст+ойчивостящее
стрессоустойчивостящие|стрэссоуст+ойчивостящие
стрессоустойчивостящих|стрэссоуст+ойчивостящих
стрессоустойчивостящими|стрэссоуст+ойчивостящими
стрессоустойчивостивший|стрэссоуст+ойчивостивший
стрессоустойчивостившего|стрэссоуст+ойчивостившего
стрессоустойчивостившему|стрэссоуст+ойчивостившему
стрессоустойчивостившим|стрэссоуст+ойчивостившим
стрессоустойчивостившем|стрэссоуст+ойчивостившем
стрессоустойчивостившая|стрэссоуст+ойчивостившая
стрессоустойчивостившей|стрэссоуст+ойчивостившей
стрессоустойчивостившую|стрэссоуст+ойчивостившую
стрессоустойчивостившею|стрэссоуст+ойчивостившею
стрессоустойчивостившее|стрэссоуст+ойчивостившее
стрессоустойчивостившие|стрэссоуст+ойчивостившие
стрессоустойчивостивших|стрэссоуст+ойчивостивших
стрессоустойчивостившими|стрэссоуст+ойчивостившими
стрессоустойчивостимый|стрэссоуст+ойчивостимый
стрессоустойчивостимого|стрэссоуст+ойчивостимого
стрессоустойчивостимому|стрэссоуст+ойчивостимому
стрессоустойчивостимым|стрэссоуст+ойчивостимым
стрессоустойчивостимом|стрэссоуст+ойчивостимом
стрессоустойчивостимая|стрэссоуст+ойчивостимая
стрессоустойчивостимой|стрэссоуст+ойчивостимой
стрессоустойчивостимую|стрэссоуст+ойчивостимую
стрессоустойчивостимою|стрэссоуст+ойчивостимою
стрессоустойчивостимое|стрэссоуст+ойчивостимое
стрессоустойчивостимые|стрэссоуст+ойчивостимые
стрессоустойчивостимых|стрэссоуст+ойчивостимых
стрессоустойчивостимыми|стрэссоуст+ойчивостимыми
стрессоустойчивощенный|стрэссоуст+ойчивощенный
стрессоустойчивощенного|стрэссоуст+ойчивощенного
стрессоустойчивощенному|стрэссоуст+ойчивощенному
стрессоустойчивощенным|стрэссоуст+ойчивощенным
стрессоустойчивощенном|стрэссоуст+ойчивощенном
стрессоустойчивощенная|стрэссоуст+ойчивощенная
стрессоустойчивощенной|стрэссоуст+ойчивощенной
стрессоустойчивощенную|стрэссоуст+ойчивощенную
стрессоустойчивощенною|стрэссоуст+ойчивощенною
стрессоустойчивощенное|стрэссоуст+ойчивощенное
стрессоустойчивощенные|стрэссоуст+ойчивощенные
стрессоустойчивощенных|стрэссоуст+ойчивощенных
стрессоустойчивощенными|стрэссоуст+ойчивощенными
стрессоустойчивостя|стрэссоуст+ойчивостя
стрессоустойчивостив|стрэссоуст+ойчивостив
стрессоустойчивостивши|стрэссоуст+ойчивостивши
стрессоустойчивостима|стрэссоуст+ойчивостима
стрессоустойчивостимо|стрэссоуст+ойчивостимо
стрессоустойчивостимы|стрэссоуст+ойчивостимы
стрессоустойчивощен|стрэссоуст+ойчивощен
стрессоустойчивощена|стрэссоуст+ойчивощена
стрессоустойчивощено|стрэссоуст+ойчивощено
стрессоустойчивощены|стрэссоуст+ойчивощены
стрессоустойчивый|стрэссоуст+ойчивый
стрессоустойчивого|стрэссоуст+ойчивого
стрессоустойчивому|стрэссоуст+ойчивому
стрессоустойчивым|стрэссоуст+ойчивым
стрессоустойчивом|стрэссоуст+ойчивом
стрессоустойчивая|стрэссоуст+ойчивая
стрессоустойчивой|стрэссоуст+ойчивой
стрессоустойчивую|стрэссоуст+ойчивую
стрессоустойчивою|стрэссоуст+ойчивою
стрессоустойчивое|стрэссоуст+ойчивое
стрессоустойчивые|стрэссоуст+ойчивые
стрессоустойчивых|стрэссоуст+ойчивых
стрессоустойчивыми|стрэссоуст+ойчивыми
стрессоустойчив|стрэссоуст+ойчив
стрессоустойчива|стрэссоуст+ойчива
стрессоустойчиво|стрэссоуст+ойчиво
стрессоустойчивы|стрэссоуст+ойчивы
стрессоустойчивее|стрэссоуст+ойчивее
стрессоустойчивей|стрэссоуст+ойчивей
метатеза|метат+эза
метатезы|метат+эзы
метатезе|метат+эзе
метатезу|метат+эзу
метатезой|метат+эзой
метатезою|метат+эзою
метатез|метат+эз
метатезам|метат+эзам
метатезами|метат+эзами
метатезах|метат+эзах
тембральный|тэмбр+альный
тембрального|тэмбр+ального
тембральному|тэмбр+альному
тембральным|тэмбр+альным
тембральном|тэмбр+альном
тембральная|тэмбр+альная
тембральной|тэмбр+альной
тембральную|тэмбр+альную
тембральною|тэмбр+альною
тембральное|тэмбр+альное
тембральные|тэмбр+альные
тембральных|тэмбр+альных
тембральными|тэмбр+альными
тембровый|т+эмбровый
тендерный|т+эндэрный
тендерного|т+эндэрного
тендерному|т+эндэрному
тендерным|т+эндэрным
тендерном|т+эндэрном
тендерная|т+эндэрная
тендерной|т+эндэрной
тендерную|т+эндэрную
тендерною|т+эндэрною
тендерное|т+эндэрное
тендерные|т+эндэрные
тендерных|т+эндэрных
тендерными|т+эндэрными
тендерен|т+эндэрен
тендерна|т+эндэрна
тендерно|т+эндэрно
тендерны|т+эндэрны
тендернее|т+эндэрнее
тендерней|т+эндэрней
теннисный|т+эннисный
теннисного|т+эннисного
теннисному|т+эннисному
теннисным|т+эннисным
теннисном|т+эннисном
теннисная|т+эннисная
теннисной|т+эннисной
теннисную|т+эннисную
теннисною|т+эннисною
теннисное|т+эннисное
теннисные|т+эннисные
теннисных|т+эннисных
теннисными|т+эннисными
теннисен|т+эннисен
теннисна|т+эннисна
теннисно|т+эннисно
теннисны|т+эннисны
тенниснее|т+энниснее
теннисней|т+эннисней
теннисист|тэннис+ист
теннисиста|тэннис+иста
теннисисту|тэннис+исту
теннисистом|тэннис+истом
теннисисте|тэннис+исте
теннисисты|тэннис+исты
теннисистов|тэннис+истов
теннисистам|тэннис+истам
теннисистами|тэннис+истами
теннисистах|тэннис+истах
теннисистка|тэннис+истка
теннисистки|тэннис+истки
теннисистке|тэннис+истке
теннисистку|тэннис+истку
теннисисткой|тэннис+исткой
теннисисткою|тэннис+исткою
теннисисток|тэннис+исток
теннисисткам|тэннис+исткам
теннисистками|тэннис+истками
теннисистках|тэннис+истках
теннисистский|тэннис+истский
теннисистского|тэннис+истского
теннисистскому|тэннис+истскому
теннисистским|тэннис+истским
теннисистском|тэннис+истском
теннисистская|тэннис+истская
теннисистской|тэннис+истской
теннисистскую|тэннис+истскую
теннисистскою|тэннис+истскою
теннисистское|тэннис+истское
теннисистские|тэннис+истские
теннисистских|тэннис+истских
теннисистскими|тэннис+истскими
термальный|тэрм+альный
термального|тэрм+ального
термальному|тэрм+альному
термальным|тэрм+альным
термальном|тэрм+альном
термальная|тэрм+альная
термальной|тэрм+альной
термальную|тэрм+альную
термальною|тэрм+альною
термальное|тэрм+альное
термальные|тэрм+альные
термальных|тэрм+альных
термальными|тэрм+альными
термосный|т+эрмосный
термосного|т+эрмосного
термосному|т+эрмосному
термосным|т+эрмосным
термосном|т+эрмосном
термосная|т+эрмосная
термосной|т+эрмосной
термосную|т+эрмосную
термосною|т+эрмосною
термосное|т+эрмосное
термосные|т+эрмосные
термосных|т+эрмосных
термосными|т+эрмосными
термосен|т+эрмосен
термосна|т+эрмосна
термосно|т+эрмосно
термосны|т+эрмосны
термоснее|т+эрмоснее
термосней|т+эрмосней
термостат|тэрмост+ат
термостата|тэрмост+ата
термостату|тэрмост+ату
термостатом|тэрмост+атом
термостате|тэрмост+ате
термостаты|тэрмост+аты
термостатов|тэрмост+атов
термостатам|тэрмост+атам
термостатами|тэрмост+атами
термостатах|тэрмост+атах
терциевый|т+эрциевый
терциевого|т+эрциевого
терциевому|т+эрциевому
терциевым|т+эрциевым
терциевом|т+эрциевом
терциевая|т+эрциевая
терциевой|т+эрциевой
терциевую|т+эрциевую
терциевою|т+эрциевою
терциевое|т+эрциевое
терциевые|т+эрциевые
терциевых|т+эрциевых
терциевыми|т+эрциевыми
фонетический|фонэт+ический
фонетического|фонэт+ического
фонетическому|фонэт+ическому
фонетическим|фонэт+ическим
фонетическом|фонэт+ическом
фонетическая|фонэт+ическая
фонетической|фонэт+ической
фонетическую|фонэт+ическую
фонетическою|фонэт+ическою
фонетическое|фонэт+ическое
фонетические|фонэт+ические
фонетических|фонэт+ических
фонетическими|фонэт+ическими
фрейлейн|фр+эйлейн
фрикадель|фрикад+эль
фрикадели|фрикад+эли
фрикаделью|фрикад+элью
фрикаделей|фрикад+элей
фрикаделям|фрикад+элям
фрикаделями|фрикад+элями
фрикаделях|фрикад+элях
экстрасенсорика|экстрасэнс+орика
экстрасенсорики|экстрасэнс+орики
экстрасенсорике|экстрасэнс+орике
экстрасенсорику|экстрасэнс+орику
экстрасенсорикой|экстрасэнс+орикой
экстрасенсорикою|экстрасэнс+орикою
экстрасенсорик|экстрасэнс+орик
экстрасенсориком|экстрасэнс+ориком
экстрасенсориков|экстрасэнс+ориков
экстрасенсорикам|экстрасэнс+орикам
экстрасенсориками|экстрасэнс+ориками
экстрасенсориках|экстрасэнс+ориках
экстрасенсорикович|экстрасэнс+орикович
экстрасенсориковича|экстрасэнс+ориковича
экстрасенсориковичу|экстрасэнс+ориковичу
экстрасенсориковичем|экстрасэнс+ориковичем
экстрасенсориковиче|экстрасэнс+ориковиче
экстрасенсориковичи|экстрасэнс+ориковичи
экстрасенсориковичей|экстрасэнс+ориковичей
экстрасенсориковичам|экстрасэнс+ориковичам
экстрасенсориковичами|экстрасэнс+ориковичами
экстрасенсориковичах|экстрасэнс+ориковичах
экстрасенсориковна|экстрасэнс+ориковна
экстрасенсориковны|экстрасэнс+ориковны
экстрасенсориковне|экстрасэнс+ориковне
экстрасенсориковну|экстрасэнс+ориковну
экстрасенсориковной|экстрасэнс+ориковной
экстрасенсориковен|экстрасэнс+ориковен
экстрасенсориковнам|экстрасэнс+ориковнам
экстрасенсориковнами|экстрасэнс+ориковнами
экстрасенсориковнах|экстрасэнс+ориковнах
экстрасенсорный|экстрасэнс+орный
экстрасенсорного|экстрасэнс+орного
экстрасенсорному|экстрасэнс+орному
экстрасенсорным|экстрасэнс+орным
экстрасенсорном|экстрасэнс+орном
экстрасенсорная|экстрасэнс+орная
экстрасенсорной|экстрасэнс+орной
экстрасенсорную|экстрасэнс+орную
экстрасенсорною|экстрасэнс+орною
экстрасенсорное|экстрасэнс+орное
экстрасенсорные|экстрасэнс+орные
экстрасенсорных|экстрасэнс+орных
экстрасенсорными|экстрасэнс+орными
экстрасенсорен|экстрасэнс+орен
экстрасенсорна|экстрасэнс+орна
экстрасенсорно|экстрасэнс+орно
экстрасенсорны|экстрасэнс+орны
биоэнергетик|биоэнэрг+етик
биоэнергетика|биоэнэрг+етика
биоэнергетику|биоэнэрг+етику
биоэнергетиком|биоэнэрг+етиком
биоэнергетике|биоэнэрг+етике
биоэнергетики|биоэнэрг+етики
биоэнергетиков|биоэнэрг+етиков
биоэнергетикам|биоэнэрг+етикам
биоэнергетиками|биоэнэрг+етиками
биоэнергетиках|биоэнэрг+етиках
биоэнергетикой|биоэнэрг+етикой
биоэнергетикою|биоэнэрг+етикою
анестезиолог|анэстэзи+олог
анестезиолога|анэстэзи+олога
анестезиологу|анэстэзи+ологу
анестезиологом|анэстэзи+ологом
анестезиологе|анэстэзи+ологе
анестезиологи|анэстэзи+ологи
анестезиологов|анэстэзи+ологов
анестезиологам|анэстэзи+ологам
анестезиологами|анэстэзи+ологами
анестезиологах|анэстэзи+ологах
анестезировать|анэстэз+ировать
анестезировал|анэстэз+ировал
анестезировала|анэстэз+ировала
анестезировало|анэстэз+ировало
анестезировали|анэстэз+ировали
анестезирую|анэстэз+ирую
анестезируем|анэстэз+ируем
анестезируешь|анэстэз+ируешь
анестезируете|анэстэз+ируете
анестезирует|анэстэз+ирует
анестезируют|анэстэз+ируют
анестезируемте|анэстэз+ируемте
анестезируй|анэстэз+ируй
анестезируйте|анэстэз+ируйте
анестезировавший|анэстэз+ировавший
анестезировавшего|анэстэз+ировавшего
анестезировавшему|анэстэз+ировавшему
анестезировавшим|анэстэз+ировавшим
анестезировавшем|анэстэз+ировавшем
анестезировавшая|анэстэз+ировавшая
анестезировавшей|анэстэз+ировавшей
анестезировавшую|анэстэз+ировавшую
анестезировавшею|анэстэз+ировавшею
анестезировавшее|анэстэз+ировавшее
анестезировавшие|анэстэз+ировавшие
анестезировавших|анэстэз+ировавших
анестезировавшими|анэстэз+ировавшими
анестезированный|анэстэз+ированный
анестезированного|анэстэз+ированного
анестезированному|анэстэз+ированному
анестезированным|анэстэз+ированным
анестезированном|анэстэз+ированном
анестезированная|анэстэз+ированная
анестезированной|анэстэз+ированной
анестезированную|анэстэз+ированную
анестезированною|анэстэз+ированною
анестезированное|анэстэз+ированное
анестезированные|анэстэз+ированные
анестезированных|анэстэз+ированных
анестезированными|анэстэз+ированными
анестезировав|анэстэз+ировав
анестезировавши|анэстэз+ировавши
анестезирующий|анэстэз+ирующий
анестезирующего|анэстэз+ирующего
анестезирующему|анэстэз+ирующему
анестезирующим|анэстэз+ирующим
анестезирующем|анэстэз+ирующем
анестезирующая|анэстэз+ирующая
анестезирующей|анэстэз+ирующей
анестезирующую|анэстэз+ирующую
анестезирующею|анэстэз+ирующею
анестезирующее|анэстэз+ирующее
анестезирующие|анэстэз+ирующие
анестезирующих|анэстэз+ирующих
анестезирующими|анэстэз+ирующими
анестезируемый|анэстэз+ируемый
анестезируемого|анэстэз+ируемого
анестезируемому|анэстэз+ируемому
анестезируемым|анэстэз+ируемым
анестезируемом|анэстэз+ируемом
анестезируемая|анэстэз+ируемая
анестезируемой|анэстэз+ируемой
анестезируемую|анэстэз+ируемую
анестезируемою|анэстэз+ируемою
анестезируемое|анэстэз+ируемое
анестезируемые|анэстэз+ируемые
анестезируемых|анэстэз+ируемых
анестезируемыми|анэстэз+ируемыми
анестезируя|анэстэз+ируя
анестезируема|анэстэз+ируема
анестезируемо|анэстэз+ируемо
анестезируемы|анэстэз+ируемы
анестезирован|анэстэз+ирован
анестезирована|анэстэз+ирована
анестезировано|анэстэз+ировано
анестезированы|анэстэз+ированы
анестетик|анест+этик
анестетика|анест+этика
анестетику|анест+этику
анестетиком|анест+этиком
анестетике|анест+этике
анестетики|анест+этики
анестетиков|анест+этиков
анестетикам|анест+этикам
анестетиками|анест+этиками
анестетиках|анест+этиках
анестезин|анестэз+ин
анестезина|анестэз+ина
анестезину|анестэз+ину
анестезином|анестэз+ином
анестезине|анестэз+ине
анестезины|анестэз+ины
анестезинов|анестэз+инов
анестезинам|анестэз+инам
анестезинами|анестэз+инами
анестезинах|анестэз+инах
погротесковее|погротэск+овее
погротесковей|погротэск+овей
подемпинговее|под+эмпинговее
подемпинговей|под+эмпинговей
депондроложе|дэпондрол+оже
депондроложа|дэпондрол+ожа
депондроложу|дэпондрол+ожу
депондроложем|дэпондрол+ожем
депондролож|дэпондрол+ож
депондроложам|дэпондрол+ожам
депондроложами|дэпондрол+ожами
депондроложах|дэпондрол+ожах
депондроложи|дэпондрол+ожи
депондроложей|дэпондрол+ожей
депондрологий|дэпондрол+огий
депондрологого|дэпондрол+огого
депондрологому|дэпондрол+огому
депондрологим|дэпондрол+огим
депондрологом|дэпондрол+огом
депондрологая|дэпондрол+огая
депондрологой|дэпондрол+огой
депондрологую|дэпондрол+огую
депондрологою|дэпондрол+огою
депондрологое|дэпондрол+огое
депондрологие|дэпондрол+огие
депондрологих|дэпондрол+огих
депондрологими|дэпондрол+огими
депондролог|дэпондрол+ог
депондролога|дэпондрол+ога
депондролого|дэпондрол+ого
депондрологи|дэпондрол+оги
депопондроложе|дэпопондр+оложе
демпингуем|дэмпинг+уем
демпингуесть|дэмпинг+уесть
демпингуел|дэмпинг+уел
демпингуела|дэмпинг+уела
демпингуело|дэмпинг+уело
демпингуели|дэмпинг+уели
демпингуедим|дэмпинг+уедим
демпингуешь|дэмпинг+уешь
демпингуедите|дэмпинг+уедите
демпингуест|дэмпинг+уест
демпингуедят|дэмпинг+уедят
демпингуедимте|дэмпинг+уедимте
демпингуешьте|дэмпинг+уешьте
демпингуевший|дэмпинг+уевший
демпингуевшего|дэмпинг+уевшего
демпингуевшему|дэмпинг+уевшему
демпингуевшим|дэмпинг+уевшим
демпингуевшем|дэмпинг+уевшем
демпингуевшая|дэмпинг+уевшая
демпингуевшей|дэмпинг+уевшей
демпингуевшую|дэмпинг+уевшую
демпингуевшею|дэмпинг+уевшею
демпингуевшее|дэмпинг+уевшее
демпингуевшие|дэмпинг+уевшие
демпингуевших|дэмпинг+уевших
демпингуевшими|дэмпинг+уевшими
демпингуеденный|дэмпинг+уеденный
демпингуеденного|дэмпинг+уеденного
демпингуеденному|дэмпинг+уеденному
демпингуеденным|дэмпинг+уеденным
демпингуеденном|дэмпинг+уеденном
демпингуеденная|дэмпинг+уеденная
демпингуеденной|дэмпинг+уеденной
демпингуеденную|дэмпинг+уеденную
демпингуеденною|дэмпинг+уеденною
демпингуеденное|дэмпинг+уеденное
демпингуеденные|дэмпинг+уеденные
демпингуеденных|дэмпинг+уеденных
демпингуеденными|дэмпинг+уеденными
демпингуев|дэмпинг+уев
демпингуевши|дэмпинг+уевши
демпингуеден|дэмпинг+уеден
демпингуедена|дэмпинг+уедена
демпингуедено|дэмпинг+уедено
демпингуедены|дэмпинг+уедены
демпингуй|дэмпинг+уй
демпингуя|дэмпинг+уя
демпингую|дэмпинг+ую
демпингуе|дэмпинг+уе
демпингуете|дэмпинг+уете
демпингует|дэмпинг+ует
демпингуют|дэмпинг+уют
демпингуйте|дэмпинг+уйте
демпингующий|дэмпинг+ующий
демпингующего|дэмпинг+ующего
демпингующему|дэмпинг+ующему
демпингующим|дэмпинг+ующим
демпингующем|дэмпинг+ующем
демпингующая|дэмпинг+ующая
демпингующей|дэмпинг+ующей
демпингующую|дэмпинг+ующую
демпингующею|дэмпинг+ующею
демпингующее|дэмпинг+ующее
демпингующие|дэмпинг+ующие
демпингующих|дэмпинг+ующих
демпингующими|дэмпинг+ующими
демпингуемый|дэмпинг+уемый
демпингуемым|дэмпинг+уемым
демпингуемую|дэмпинг+уемую
демпингуемые|дэмпинг+уемые
демпингуемых|дэмпинг+уемых
демпингуемыми|дэмпинг+уемыми
демпингуемы|дэмпинг+уемы
демпингуема|дэмпинг+уема
демпингуемая|дэмпинг+уемая
демпингуемо|дэмпинг+уемо
демпингуемого|дэмпинг+уемого
демпингуть|дэмпинг+уть
демпингул|дэмпинг+ул
демпингула|дэмпинг+ула
демпингуло|дэмпинг+уло
демпингули|дэмпинг+ули
демпингувший|дэмпинг+увший
демпингувшего|дэмпинг+увшего
демпингувшему|дэмпинг+увшему
демпингувшим|дэмпинг+увшим
демпингувшем|дэмпинг+увшем
демпингувшая|дэмпинг+увшая
демпингувшей|дэмпинг+увшей
демпингувшую|дэмпинг+увшую
демпингувшею|дэмпинг+увшею
демпингувшее|дэмпинг+увшее
демпингувшие|дэмпинг+увшие
демпингувших|дэмпинг+увших
демпингувшими|дэмпинг+увшими
демпингув|дэмпинг+ув
демпингувши|дэмпинг+увши
демпингуемое|дэмпинг+уемое
демпингуемой|дэмпинг+уемой
демпингуемом|дэмпинг+уемом
демпингуемому|дэмпинг+уемому
демпингуемою|дэмпинг+уемою
демпингуемте|дэмпинг+уемте
демпингуём|дэмпинг+уём
демпингуёшь|дэмпинг+уёшь
демпингуёте|дэмпинг+уёте
демпингуёт|дэмпинг+уёт
демпингуёмте|дэмпинг+уёмте
компьютеризуем|компьютэриз+уем
компьютеризую|компьютэриз+ую
компьютеризуешь|компьютэриз+уешь
компьютеризуете|компьютэриз+уете
компьютеризует|компьютэриз+ует
компьютеризуют|компьютэриз+уют
компьютеризуемте|компьютэриз+уемте
компьютеризуй|компьютэриз+уй
компьютеризуйте|компьютэриз+уйте
компьютеризующий|компьютэриз+ующий
компьютеризующего|компьютэриз+ующего
компьютеризующему|компьютэриз+ующему
компьютеризующим|компьютэриз+ующим
компьютеризующем|компьютэриз+ующем
компьютеризующая|компьютэриз+ующая
компьютеризующей|компьютэриз+ующей
компьютеризующую|компьютэриз+ующую
компьютеризующею|компьютэриз+ующею
компьютеризующее|компьютэриз+ующее
компьютеризующие|компьютэриз+ующие
компьютеризующих|компьютэриз+ующих
компьютеризующими|компьютэриз+ующими
компьютеризуемый|компьютэриз+уемый
компьютеризуемого|компьютэриз+уемого
компьютеризуемому|компьютэриз+уемому
компьютеризуемым|компьютэриз+уемым
компьютеризуемом|компьютэриз+уемом
компьютеризуемая|компьютэриз+уемая
компьютеризуемой|компьютэриз+уемой
компьютеризуемую|компьютэриз+уемую
компьютеризуемою|компьютэриз+уемою
компьютеризуемое|компьютэриз+уемое
компьютеризуемые|компьютэриз+уемые
компьютеризуемых|компьютэриз+уемых
компьютеризуемыми|компьютэриз+уемыми
компьютеризуя|компьютэриз+уя
компьютеризуема|компьютэриз+уема
компьютеризуемо|компьютэриз+уемо
компьютеризуемы|компьютэриз+уемы
поадептче|поад+эптче
поадептч|поад+эптч
поадептча|поад+эптча
поадептчу|поад+эптчу
поадептчем|поад+эптчем
поадептчи|поад+эптчи
поадептчей|поад+эптчей
поадептчам|поад+эптчам
поадептчами|поад+эптчами
поадептчах|поад+эптчах
поадепткий|поад+эпткий
поадепткого|поад+эпткого
поадепткому|поад+эпткому
поадептким|поад+эптким
поадептком|поад+эптком
поадепткая|поад+эпткая
поадепткой|поад+эпткой
поадепткую|поад+эпткую
поадепткою|поад+эпткою
поадепткое|поад+эпткое
поадепткие|поад+эпткие
поадептких|поад+эптких
поадепткими|поад+эпткими
поадепток|поад+эпток
поадептка|поад+эптка
поадептко|поад+эптко
поадептки|поад+эптки
поатеистичнее|поатэист+ичнее
поатеистичней|поатэист+ичней
поатеистичный|поатэист+ичный
поатеистичного|поатэист+ичного
поатеистичному|поатэист+ичному
поатеистичным|поатэист+ичным
поатеистичном|поатэист+ичном
поатеистичная|поатэист+ичная
поатеистичной|поатэист+ичной
поатеистичную|поатэист+ичную
поатеистичною|поатэист+ичною
поатеистичное|поатэист+ичное
поатеистичные|поатэист+ичные
поатеистичных|поатэист+ичных
поатеистичными|поатэист+ичными
поатеистичен|поатэист+ичен
поатеистична|поатэист+ична
поатеистично|поатэист+ично
поатеистичны|поатэист+ичны
погротескнее|погрот+эскнее
погротескней|погрот+эскней
подекоративнее|подэкорат+ивнее
подекоративней|подэкорат+ивней
поделикатеснее|поделикат+эснее
поделикатесней|поделикат+эсней
подерматиновее|подэрмат+иновее
подерматиновей|подэрмат+иновей
подетективнее|подэтэкт+ивнее
подетективней|подэтэкт+ивней
подетекторнее|подэт+экторнее
подетекторней|подэт+экторней
подециметровее|подэцим+етровее
подециметровей|подэцим+етровей
поиндекснее|по+индэкснее
поиндексней|по+индэксней
поконсенсуснее|поконс+энсуснее
поконсенсусный|поконс+энсусный
поконсенсусного|поконс+энсусного
поконсенсусному|поконс+энсусному
поконсенсусным|поконс+энсусным
поконсенсусном|поконс+энсусном
поконсенсусная|поконс+энсусная
поконсенсусной|поконс+энсусной
поконсенсусную|поконс+энсусную
поконсенсусною|поконс+энсусною
поконсенсусное|поконс+энсусное
поконсенсусные|поконс+энсусные
поконсенсусных|поконс+энсусных
поконсенсусными|поконс+энсусными
поконсенсусен|поконс+энсусен
поконсенсусна|поконс+энсусна
поконсенсусно|поконс+энсусно
поконсенсусны|поконс+энсусны
поконсенсусней|поконс+энсусней
покрепдешиновее|покрепдэш+иновее
покрепдешиновей|покрепдэш+иновей
попоадептче|попоад+эптче
попоадептч|попоад+эптч
попоадептча|попоад+эптча
попоадептчу|попоад+эптчу
попоадептчем|попоад+эптчем
попоадептчи|попоад+эптчи
попоадептчей|попоад+эптчей
попоадептчам|попоад+эптчам
попоадептчами|попоад+эптчами
попоадептчах|попоад+эптчах
попоадепткий|попоад+эпткий
попоадепткого|попоад+эпткого
попоадепткому|попоад+эпткому
попоадептким|попоад+эптким
попоадептком|попоад+эптком
попоадепткая|попоад+эпткая
попоадепткой|попоад+эпткой
попоадепткую|попоад+эпткую
попоадепткою|попоад+эпткою
попоадепткое|попоад+эпткое
попоадепткие|попоад+эпткие
попоадептких|попоад+эптких
попоадепткими|попоад+эпткими
попоадепток|попоад+эпток
попоадептка|попоад+эптка
попоадептко|попоад+эптко
попоадептки|попоад+эптки
попоатеистичнее|попоатэист+ичнее
попоатеистичней|попоатэист+ичней
попоатеистичный|попоатэист+ичный
попоатеистичного|попоатэист+ичного
попоатеистичному|попоатэист+ичному
попоатеистичным|попоатэист+ичным
попоатеистичном|попоатэист+ичном
попоатеистичная|попоатэист+ичная
попоатеистичной|попоатэист+ичной
попоатеистичную|попоатэист+ичную
попоатеистичною|попоатэист+ичною
попоатеистичное|попоатэист+ичное
попоатеистичные|попоатэист+ичные
попоатеистичных|попоатэист+ичных
попоатеистичными|попоатэист+ичными
попоатеистичен|попоатэист+ичен
попоатеистична|попоатэист+ична
попоатеистично|попоатэист+ично
попоатеистичны|попоатэист+ичны
попоконсенсуснее|попоконс+энсуснее
попоконсенсусный|попоконс+энсусный
попоконсенсусного|попоконс+энсусного
попоконсенсусному|попоконс+энсусному
попоконсенсусным|попоконс+энсусным
попоконсенсусном|попоконс+энсусном
попоконсенсусная|попоконс+энсусная
попоконсенсусной|попоконс+энсусной
попоконсенсусную|попоконс+энсусную
попоконсенсусною|попоконс+энсусною
попоконсенсусное|попоконс+энсусное
попоконсенсусные|попоконс+энсусные
попоконсенсусных|попоконс+энсусных
попоконсенсусными|попоконс+энсусными
попоконсенсусен|попоконс+энсусен
попоконсенсусна|попоконс+энсусна
попоконсенсусно|попоконс+энсусно
попоконсенсусны|попоконс+энсусны
попоконсенсусней|попоконс+энсусней
попротекционнее|попротэкци+оннее
попротекционней|попротэкци+онней
посентенциознее|посентэнци+ознее
посентенциозней|посентэнци+озней
посонетнее|посон+этнее
посонетней|посон+этней
пострессовее|пострэсс+овее
пострессовый|пострэсс+овый
пострессового|пострэсс+ового
пострессовому|пострэсс+овому
пострессовым|пострэсс+овым
пострессовом|пострэсс+овом
пострессовая|пострэсс+овая
пострессовой|пострэсс+овой
пострессовую|пострэсс+овую
пострессовою|пострэсс+овою
пострессовое|пострэсс+овое
пострессовые|пострэсс+овые
пострессовых|пострэсс+овых
пострессовыми|пострэсс+овыми
пострессов|пострэсс+ов
пострессова|пострэсс+ова
пострессово|пострэсс+ово
пострессовы|пострэсс+овы
пострессовей|постресс+овей
пострессоветь|постресс+оветь
пострессовею|постресс+овею
пострессовеем|постресс+овеем
пострессовеешь|постресс+овеешь
пострессовеете|постресс+овеете
пострессовеет|постресс+овеет
пострессовеют|постресс+овеют
пострессовел|постресс+овел
пострессовела|постресс+овела
пострессовело|постресс+овело
пострессовели|постресс+овели
пострессовейте|постресс+овейте
пострессовеющий|постресс+овеющий
пострессовеющего|постресс+овеющего
пострессовеющему|постресс+овеющему
пострессовеющим|постресс+овеющим
пострессовеющем|постресс+овеющем
пострессовеющая|постресс+овеющая
пострессовеющей|постресс+овеющей
пострессовеющую|постресс+овеющую
пострессовеющею|постресс+овеющею
пострессовеющее|постресс+овеющее
пострессовеющие|постресс+овеющие
пострессовеющих|постресс+овеющих
пострессовеющими|постресс+овеющими
пострессовевший|постресс+овевший
пострессовевшего|постресс+овевшего
пострессовевшему|постресс+овевшему
пострессовевшим|постресс+овевшим
пострессовевшем|постресс+овевшем
пострессовевшая|постресс+овевшая
пострессовевшей|постресс+овевшей
пострессовевшую|постресс+овевшую
пострессовевшею|постресс+овевшею
пострессовевшее|постресс+овевшее
пострессовевшие|постресс+овевшие
пострессовевших|постресс+овевших
пострессовевшими|постресс+овевшими
пострессовея|постресс+овея
пострессовев|постресс+овев
пострессовевши|постресс+овевши
пострессовеять|постресс+овеять
пострессовеял|постресс+овеял
пострессовеяла|постресс+овеяла
пострессовеяло|постресс+овеяло
пострессовеяли|постресс+овеяли
пострессовеемте|постресс+овеемте
пострессовеявший|постресс+овеявший
пострессовеявшего|постресс+овеявшего
пострессовеявшему|постресс+овеявшему
пострессовеявшим|постресс+овеявшим
пострессовеявшем|постресс+овеявшем
пострессовеявшая|постресс+овеявшая
пострессовеявшей|постресс+овеявшей
пострессовеявшую|постресс+овеявшую
пострессовеявшею|постресс+овеявшею
пострессовеявшее|постресс+овеявшее
пострессовеявшие|постресс+овеявшие
пострессовеявших|постресс+овеявших
пострессовеявшими|постресс+овеявшими
пострессовеянный|постресс+овеянный
пострессовеянного|постресс+овеянного
пострессовеянному|постресс+овеянному
пострессовеянным|постресс+овеянным
пострессовеянном|постресс+овеянном
пострессовеянная|постресс+овеянная
пострессовеянной|постресс+овеянной
пострессовеянную|постресс+овеянную
пострессовеянною|постресс+овеянною
пострессовеянное|постресс+овеянное
пострессовеянные|постресс+овеянные
пострессовеянных|постресс+овеянных
пострессовеянными|постресс+овеянными
пострессовеяв|постресс+овеяв
пострессовеявши|постресс+овеявши
пострессовеян|постресс+овеян
пострессовеяна|постресс+овеяна
пострессовеяно|постресс+овеяно
пострессовеяны|постресс+овеяны
пострессовить|постресс+овить
пострессовил|постресс+овил
пострессовила|постресс+овила
пострессовило|постресс+овило
пострессовили|постресс+овили
пострессовью|постресс+овью
пострессовьём|постресс+овьём
пострессовьёшь|постресс+овьёшь
пострессовьёте|постресс+овьёте
пострессовьёт|постресс+овьёт
пострессовьют|постресс+овьют
пострессовьёмте|постресс+овьёмте
пострессовивший|постресс+овивший
пострессовившего|постресс+овившего
пострессовившему|постресс+овившему
пострессовившим|постресс+овившим
пострессовившем|постресс+овившем
пострессовившая|постресс+овившая
пострессовившей|постресс+овившей
пострессовившую|постресс+овившую
пострессовившею|постресс+овившею
пострессовившее|постресс+овившее
пострессовившие|постресс+овившие
пострессовивших|постресс+овивших
пострессовившими|постресс+овившими
пострессовитый|постресс+овитый
пострессовитого|постресс+овитого
пострессовитому|постресс+овитому
пострессовитым|постресс+овитым
пострессовитом|постресс+овитом
пострессовитая|постресс+овитая
пострессовитой|постресс+овитой
пострессовитую|постресс+овитую
пострессовитою|постресс+овитою
пострессовитое|постресс+овитое
пострессовитые|постресс+овитые
пострессовитых|постресс+овитых
пострессовитыми|постресс+овитыми
пострессовив|постресс+овив
пострессовивши|постресс+овивши
пострессовит|постресс+овит
пострессовита|постресс+овита
пострессовито|постресс+овито
пострессовиты|постресс+овиты
пострессовеемый|постресс+овеемый
пострессовеемого|постресс+овеемого
пострессовеемому|постресс+овеемому
пострессовеемым|постресс+овеемым
пострессовеемом|постресс+овеемом
пострессовеемая|постресс+овеемая
пострессовеемой|постресс+овеемой
пострессовеемую|постресс+овеемую
пострессовеемою|постресс+овеемою
пострессовеемое|постресс+овеемое
пострессовеемые|постресс+овеемые
пострессовеемых|постресс+овеемых
пострессовеемыми|постресс+овеемыми
пострессовеема|постресс+овеема
пострессовеемо|постресс+овеемо
пострессовеемы|постресс+овеемы
пострессовьющий|постресс+овьющий
пострессовьющего|постресс+овьющего
пострессовьющему|постресс+овьющему
пострессовьющим|постресс+овьющим
пострессовьющем|постресс+овьющем
пострессовьющая|постресс+овьющая
пострессовьющей|постресс+овьющей
пострессовьющую|постресс+овьющую
пострессовьющею|постресс+овьющею
пострессовьющее|постресс+овьющее
пострессовьющие|постресс+овьющие
пострессовьющих|постресс+овьющих
пострессовьющими|постресс+овьющими
пострессоустойчивее|пострэссоуст+ойчивее
пострессоустойчивый|пострэссоуст+ойчивый
пострессоустойчивого|пострэссоуст+ойчивого
пострессоустойчивому|пострэссоуст+ойчивому
пострессоустойчивым|пострэссоуст+ойчивым
пострессоустойчивом|пострэссоуст+ойчивом
пострессоустойчивая|пострэссоуст+ойчивая
пострессоустойчивой|пострэссоуст+ойчивой
пострессоустойчивую|пострэссоуст+ойчивую
пострессоустойчивою|пострэссоуст+ойчивою
пострессоустойчивое|пострэссоуст+ойчивое
пострессоустойчивые|пострэссоуст+ойчивые
пострессоустойчивых|пострэссоуст+ойчивых
пострессоустойчивыми|пострэссоуст+ойчивыми
пострессоустойчивейший|пострэссоуст+ойчивейший
пострессоустойчивейшего|пострэссоуст+ойчивейшего
пострессоустойчивейшему|пострэссоуст+ойчивейшему
пострессоустойчивейшим|пострэссоуст+ойчивейшим
пострессоустойчивейшем|пострэссоуст+ойчивейшем
пострессоустойчивейшая|пострэссоуст+ойчивейшая
пострессоустойчивейшей|пострэссоуст+ойчивейшей
пострессоустойчивейшую|пострэссоуст+ойчивейшую
пострессоустойчивейшею|пострэссоуст+ойчивейшею
пострессоустойчивейшее|пострэссоуст+ойчивейшее
пострессоустойчивейшие|пострэссоуст+ойчивейшие
пострессоустойчивейших|пострэссоуст+ойчивейших
пострессоустойчивейшими|пострэссоуст+ойчивейшими
пострессоустойчив|пострэссоуст+ойчив
пострессоустойчива|пострэссоуст+ойчива
пострессоустойчиво|пострэссоуст+ойчиво
пострессоустойчивы|пострэссоуст+ойчивы
пострессоустойчивей|пострэссоуст+ойчивей
